AByanwaram	AByanwara<vargaH:nA><lifgam:napuM><viBakwiH:1><vacanam:eka><level:1>/AByanwara<vargaH:nA><lifgam:napuM><viBakwiH:2><vacanam:eka><level:1>/AByanwara<vargaH:nA><lifgam:puM><viBakwiH:2><vacanam:eka><level:1>
ASvAsayAmAsa	Svas1<upasarga:Af><sanAxi_prawyayaH:Nic><prayogaH:karwari><lakAraH:lit><puruRaH:pra><vacanam:eka><paxI:parasmEpaxI><XAwuH:Svasaz><gaNaH:axAxiH><level:1>
ASvAsayaw	Svi1<upasarga:Af><sanAxi_prawyayaH:Nic><prayogaH:karwari><lakAraH:laf><puruRaH:pra><vacanam:eka><paxI:parasmEpaxI><XAwuH:tuOSvi><gaNaH:BvAxiH><level:1>
ASvAsya	Svas1<upasarga:Af><vargaH:avy><kqw_prawyayaH:lyap><XAwuH:Svasaz><gaNaH:axAxiH><level:1>
AcCannaH	Cax1<upasarga:Af><kqw_prawyayaH:kwa><XAwuH:Caxiz><gaNaH:curAxiH><kqw_pratipadika:AcCanna><vargaH:nA><lifgam:puM><viBakwiH:1><vacanam:eka><level:1>
Aganwum	gam1<vargaH:avy><upasarga:Af><kqw_prawyayaH:wumun><XAwuH:gamlqz><gaNaH:BvAxiH><level:1>
AgawavAn	Agawavaw<vargaH:nA><lifgam:puM><viBakwiH:1><vacanam:eka><level:1>
AhvayAmaH	hve1<upasarga:Af><prayogaH:karwari><lakAraH:lat><puruRaH:u><vacanam:bahu><paxI:parasmEpaxI><XAwuH:hveF><gaNaH:BvAxiH><level:1>
Ahvaya	hve1<upasarga:Af><prayogaH:karwari><lakAraH:lot><puruRaH:ma><vacanam:eka><paxI:parasmEpaxI><XAwuH:hveF><gaNaH:BvAxiH><level:1>
Ahvayawi	hve1<upasarga:Af><prayogaH:karwari><lakAraH:lat><puruRaH:pra><vacanam:eka><paxI:parasmEpaxI><XAwuH:hveF><gaNaH:BvAxiH><level:1>
AjFApayAmi	jFA1<upasarga:Af><prayogaH:karwari><lakAraH:lat><puruRaH:u><vacanam:eka><paxI:parasmEpaxI><XAwuH:jFA><gaNaH:kryAxiH><level:1>
AjFApayasi	jFA1<upasarga:Af><prayogaH:karwari><lakAraH:lat><puruRaH:ma><vacanam:eka><paxI:parasmEpaxI><XAwuH:jFA><gaNaH:kryAxiH><level:1>
AjFApayawi	jFA2<upasarga:Af><prayogaH:karwari><lakAraH:lat><puruRaH:pra><vacanam:eka><paxI:parasmEpaxI><XAwuH:jFA><gaNaH:curAxiH><level:1>
AkAraya	kq3<upasarga:Af><sanAxi_prawyayaH:Nic><prayogaH:karwari><lakAraH:lot><puruRaH:ma><vacanam:eka><paxI:parasmEpaxI><XAwuH:dukqF><gaNaH:kryAxiH><level:1>
AkRipan	AkRipaw<vargaH:nA><lifgam:puM><viBakwiH:1><vacanam:eka><level:1>
AkRipaw	kRip1<upasarga:Af><prayogaH:karwari><lakAraH:laf><puruRaH:pra><vacanam:eka><paxI:parasmEpaxI><XAwuH:kSipa><gaNaH:BvAxiH><level:1>
AkarNayaw	karNa1<upasarga:Af><prayogaH:karwari><lakAraH:laf><puruRaH:pra><vacanam:eka><paxI:parasmEpaxI><XAwuH:karNa><gaNaH:curAxiH><level:1>
AkarNya	karNa1<upasarga:Af><vargaH:avy><kqw_prawyayaH:lyap><XAwuH:karNaz><gaNaH:curAxiH><level:1>
AkqwIni	Akqwi<vargaH:nA><lifgam:napuM><viBakwiH:2><vacanam:bahu><level:1>
AkulaH	kul1<upasarga:Af><kqw_prawyayaH:ka><XAwuH:kulaz><gaNaH:BvAxiH><kqw_pratipadika:Akula><vargaH:nA><lifgam:puM><viBakwiH:1><vacanam:eka><level:1>
AnIwavAn	AnIwavaw<vargaH:nA><lifgam:puM><viBakwiH:1><vacanam:eka><level:1>
AnIwavanwaH	AnIwavaw<vargaH:nA><lifgam:puM><viBakwiH:1><vacanam:bahu><level:1>
ApUrya	pUr2<upasarga:Af><vargaH:avy><kqw_prawyayaH:lyap><XAwuH:pUrIz><gaNaH:xivAxiH><level:1>
ApUryamANam	ApUryamANa<vargaH:nA><lifgam:puM><viBakwiH:2><vacanam:eka><level:1>
ApawiwA	ApawiwA<vargaH:nA><lifgam:swrI><viBakwiH:1><vacanam:eka><level:1>
ApawiwaH	paw1<upasarga:Af><kqw_prawyayaH:kwa><XAwuH:pwL><gaNaH:BvAxiH><kqw_pratipadika:Apawiwa><vargaH:nA><lifgam:puM><viBakwiH:1><vacanam:eka><level:1>
ArUDavAn	ruh1<upasarga:Af><kqw_prawyayaH:kwavawu><XAwuH:ruha><gaNaH:BvAxiH><kqw_pratipadika:ArUDavaw><vargaH:nA><lifgam:puM><viBakwiH:1><vacanam:eka><level:1>
AraBase	raB1<upasarga:Af><prayogaH:karwari><lakAraH:lat><puruRaH:ma><vacanam:eka><paxI:AwmanepaxI><XAwuH:raBaz><gaNaH:BvAxiH><level:1>
AraBawe	raB1<upasarga:Af><prayogaH:karwari><lakAraH:lat><puruRaH:pra><vacanam:eka><paxI:AwmanepaxI><XAwuH:raBaz><gaNaH:BvAxiH><level:1>
AraBe	raB1<upasarga:Af><prayogaH:karwari><lakAraH:lat><puruRaH:u><vacanam:eka><paxI:AwmanepaxI><XAwuH:raBa><gaNaH:BvAxiH><level:1>
AraBewAm	raB1<upasarga:Af><prayogaH:karwari><lakAraH:laf><puruRaH:pra><vacanam:xvi><paxI:AwmanepaxI><XAwuH:raBa><gaNaH:BvAxiH><level:1>
ArabXAvanwO	raB1<upasarga:Af><kqw_prawyayaH:kwavawu><XAwuH:raBaz><gaNaH:BvAxiH><kqw_pratipadika:ArabXavaw><vargaH:nA><lifgam:puM><viBakwiH:1><vacanam:xvi><level:1>/raB1<upasarga:Af><kqw_prawyayaH:kwavawu><XAwuH:raBaz><gaNaH:BvAxiH><kqw_pratipadika:ArabXavaw><vargaH:nA><lifgam:puM><viBakwiH:2><vacanam:xvi><level:1>
ArabXAvanwaH	raB1<upasarga:Af><kqw_prawyayaH:kwavawu><XAwuH:raBaz><gaNaH:BvAxiH><kqw_pratipadika:ArabXavaw><vargaH:nA><lifgam:puM><viBakwiH:1><vacanam:eka><level:1>/raB1<upasarga:Af><kqw_prawyayaH:kwavawu><XAwuH:raBaz><gaNaH:BvAxiH><kqw_pratipadika:ArabXavaw><vargaH:nA><lifgam:puM><viBakwiH:2><vacanam:eka><level:1>
ArabXavAn	ArabXavaw<vargaH:nA><lifgam:puM><viBakwiH:1><vacanam:eka><level:1>
ArakRiNaH	ArakRin<vargaH:nA><lifgam:puM><viBakwiH:1><vacanam:bahu><level:1>/ArakRin<vargaH:nA><lifgam:puM><viBakwiH:2><vacanam:bahu><level:1>/ArakRin<vargaH:nA><lifgam:puM><viBakwiH:5><vacanam:eka><level:1>/ArakRin<vargaH:nA><lifgam:puM><viBakwiH:6><vacanam:eka><level:1>/ArakRin<vargaH:nA><lifgam:puM><viBakwiH:6><vacanam:bahu><level:1>
ArakRisWAne	ArakRisWAna<vargaH:nA><lifgam:napuM><viBakwiH:1><vacanam:eka><level:1>
AsAxya	Rax1<upasarga:Af><vargaH:avy><sanAxi_prawyayaH:Nic><kqw_prawyayaH:lyap><XAwuH:RaxL><gaNaH:BvAxiH><level:1>
AsakwA	AsakwA<vargaH:nA><lifgam:swrI><viBakwiH:1><vacanam:eka><level:1>
AsasAxa	sax1<upasarga:Af><prayogaH:karwari><lakAraH:lit><puruRaH:pra><vacanam:eka><paxI:parasmEpaxI><XAwuH:Saxlri><gaNaH:wuxAxiH><level:1>
Asaxaw	sax1<prayogaH:karwari><lakAraH:lqf><puruRaH:pra><vacanam:eka><paxI:parasmEpaxI><gaNaH:BvAxiH><level:1>
AwIwAm	awIwa<vargaH:nA><lifgam:swrI><viBakwiH:2><vacanam:eka><level:1>
AxeSaya	xiS1<upasarga:Af><sanAxi_prawyayaH:Nic><prayogaH:karwari><lakAraH:lot><puruRaH:ma><vacanam:eka><paxI:parasmEpaxI><XAwuH:xiSaz><gaNaH:axAxiH><level:1>
AxiRtavAn	AxiRtavaw<vargaH:nA><lifgam:puM><viBakwiH:1><vacanam:eka><level:1>
Axriyawe	xq1<upasarga:Af><prayogaH:karmaNi><lakAraH:lat><puruRaH:pra><vacanam:eka><paxI:parasmEpaxI><XAwuH:NIF><gaNaH:svAxiH><level:1>
Ayojayaw	yuj2<upasarga:Af><prayogaH:karwari><lakAraH:laf><puruRaH:pra><vacanam:eka><paxI:parasmEpaxI><XAwuH:yuja><gaNaH:curAxiH><level:1>
AyojiwavAn	Ayojiwavaw<vargaH:nA><lifgam:puM><viBakwiH:1><vacanam:eka><level:1>
AyuRmanwam	AyuRmat<vargaH:nA><lifgam:puM><viBakwiH:2><vacanam:eka><level:1>
BAvayanwaH	BAvayaw<vargaH:nA><lifgam:puM><viBakwiH:1><vacanam:bahu><level:1>
BAvayanwaH	BU1<upasarga:X><kqw_prawyayaH:Sawq_lat><XAwuH:gamL><gaNaH:BvAxiH>BAvayaw<vargaH:nA><lifgam:puM><viBakwiH:1><vacanam:bahu><level:1>/BU1<upasarga:X><kqw_prawyayaH:Sawq_lat><XAwuH:gamL><gaNaH:BvAxiH>BAvayaw<vargaH:nA><lifgam:puM><viBakwiH:1><vacanam:bahu><level:1>
BIruwvam	BIruwva<vargaH:nA><lifgam:napuM><viBakwiH:2><vacanam:eka><level:1>/BIruwva<vargaH:nA><lifgam:napuM><viBakwiH:1><vacanam:eka><level:1>
BUH	BU1<prayogaH:karwari><lakAraH:mA_luf><puruRaH:ma><vacanam:eka><paxI:parasmEpaxI><gaNaH:BvAxiH><level:1>
BURaNam	BURaNa<vargaH:nA><lifgam:napuM><viBakwiH:1><vacanam:eka><level:1>/BURaNa<vargaH:nA><lifgam:napuM><viBakwiH:2><vacanam:eka><level:1>
BUmipO	BUmipa<vargaH:nA><lifgam:puM><viBakwiH:1><vacanam:xvi><level:1>
BUmiwra	BUmiwra<vargaH:nA><lifgam:puM><viBakwiH:8><vacanam:eka><level:1>
BUmiwraH	BUmiwra<vargaH:nA><lifgam:puM><viBakwiH:1><vacanam:eka><level:1>
BaRamANAn	BaR1<kqw_prawyayaH:SAnac_lat><XAwuH:BaRaz><gaNaH:BvAxiH><kqw_pratipadika:BaRamANa><vargaH:nA><lifgam:puM><viBakwiH:2><vacanam:bahu><level:1>
BaRamANaH	BaR1<kqw_prawyayaH:SAnac_lat><XAwuH:BaRaz><gaNaH:BvAxiH><kqw_pratipadika:BaRamANa><vargaH:nA><lifgam:puM><viBakwiH:1><vacanam:eka><level:1>
BagavaxgIwAyAH	BagavaxgIwA<vargaH:nA><lifgam:swrI><viBakwiH:6><vacanam:eka><level:1>
BakRayiwum	BakR2<vargaH:avy><kqw_prawyayaH:wumun><XAwuH:BakRa><gaNaH:curAxiH><level:1>
BakRayiwvA	BakR2<vargaH:avy><sanAxi_prawyayaH:Nic><kqw_prawyayaH:kwvA><XAwuH:BakRaz><gaNaH:curAxiH><level:1>/BakR2<vargaH:avy><kqw_prawyayaH:kwvA><XAwuH:BakRaz><gaNaH:curAxiH><level:1>
BakRiwavAn	BakRiwavaw<vargaH:nA><lifgam:puM><viBakwiH:1><vacanam:eka><level:1>
BarawarRaBa	BarawarRaBa<vargaH:nA><lifgam:puM><viBakwiH:8><vacanam:eka><level:1>
Bayafkaram	Bayafkara<vargaH:nA><lifgam:napuM><viBakwiH:1><vacanam:eka><level:1>/Bayafkara<vargaH:nA><lifgam:napuM><viBakwiH:2><vacanam:eka><level:1>/Bayafkara<vargaH:nA><lifgam:puM><viBakwiH:2><vacanam:eka><level:1>
BojayanwaH	Bojayaw<vargaH:nA><lifgam:puM><viBakwiH:1><vacanam:bahu><level:1>
BojayiRyAmi	Buj1<sanAxi_prawyayaH:Nic><prayogaH:karwari><lakAraH:lqt><puruRaH:u><vacanam:eka><paxI:parasmEpaxI><XAwuH:Buja><gaNaH:ruXAxiH><level:1>
BojayiRyAmi	Buj1<sanAxi_prawyayaH:Nic><prayogaH:karwari><lakAraH:lrit><puruRaH:u><vacanam:eka><paxI:parasmEpaxI><XAwuH:Buj><gaNaH:ruXAxiH><level:1>
BojiwavAn	Bojiwavaw<vargaH:nA><lifgam:puM><viBakwiH:1><vacanam:eka><level:1>
BrAmayan	Bramayaw<vargaH:nA><lifgam:puM><viBakwiH:1><vacanam:eka><level:1>
BrAmayiwum	Bram1<vargaH:avy><sanAxi_prawyayaH:Nic><kqw_prawyayaH:wumun><XAwuH:Bramu><gaNaH:xivAxiH><level:1>
BramaNAya	Bram1<kqw_prawyayaH:lyut><XAwuH:Bramuz><gaNaH:BvAxiH><kqw_pratipadika:BramaNa><vargaH:nA><lifgam:napuM><viBakwiH:4><vacanam:eka><level:1>
BuFjAnaH	<kqw_XAwu:Buj2><upasarga:X><kqw_prawyayaH:SAnac_lat><XAwuH:Bujaz><gaNaH:ruXAxiH>BuFjAna<vargaH:nA><lifgam:puM><viBakwiH:1><vacanam:eka><level:1>
CalayawAm	Calayaw<vargaH:nA><lifgam:napuM><viBakwiH:6><vacanam:bahu><level:1>
GAwakaH	GAwaka<vargaH:nA><lifgam:puM><viBakwiH:1><vacanam:eka><level:1>
KAxayanwaH	KAxayaw<vargaH:nA><lifgam:puM><viBakwiH:1><vacanam:bahu><level:1>
SaSakaH	SaSaka<vargaH:nA><lifgam:puM><viBakwiH:1><vacanam:eka><level:1>
Samayiwum	Sam1<vargaH:avy><sanAxi_prawyayaH:Nic><kqw_prawyayaH:wumun><XAwuH:Samu><gaNaH:xibAxiH><level:1>
SayAna	SI1<kqw_prawyayaH:SAnac_lat><XAwuH:SIf><gaNaH:axAxiH><level:1>
SikRayiwum	SikR1<vargaH:avy><sanAxi_prawyayaH:Nic><kqw_prawyayaH:wumun><XAwuH:SikRa><gaNaH:BvAxiH><level:1>
SqNvan	SqNvaw<vargaH:nA><lifgam:puM><viBakwiH:1><vacanam:eka><level:1>
SqNvawaH	SqNvaw<vargaH:nA><lifgam:puM><viBakwiH:2><vacanam:bahu><level:1>/SqNvaw<vargaH:nA><lifgam:puM><viBakwiH:5><vacanam:eka><level:1>/SqNvaw<vargaH:nA><lifgam:puM><viBakwiH:6><vacanam:eka><level:1>
SrAvayawi	Sru1<sanAxi_prawyayaH:Nic><prayogaH:karwari><lakAraH:lat><puruRaH:pra><vacanam:eka><paxI:parasmEpaxI><XAwuH:Sru><gaNaH:wanAxiH><level:1>
SrAvayiwum	Sru1<vargaH:avy><sanAxi_prawyayaH:Nic><kqw_prawyayaH:wumun><XAwuH:Sru><gaNaH:wanAxiH><level:1>
SrAvayiwvA	Sru1<vargaH:avy><sanAxi_prawyayaH:Nic><kqw_prawyayaH:kwvA><XAwuH:Sru><gaNaH:wanAxiH><level:1>
SrAviwavAn	SrAviwavaw<vargaH:nA><lifgam:puM><viBakwiH:1><vacanam:eka><level:1>
SrAviwavawI	SrAviwavawI<vargaH:nA><lifgam:swrI><viBakwiH:1><vacanam:eka><level:1>
SrAviwavawi	SrAviwavawi<vargaH:nA><lifgam:strI><viBakwiH:1><vacanam:eka><level:1>
SrIReNasya	SrIReNa<vargaH:nA><lifgam:puM><viBakwiH:6><vacanam:eka><level:1>
SrIkqRNaH	SrIkqRNa<vargaH:nA><lifgam:puM><viBakwiH:1><vacanam:eka><level:1>
SravaNena	Sq1<upasarga:X><kqw_prawyayaH:lyut><XAwuH:Sqz><gaNaH:BvAxiH><kqw_pratipadika:SravaNa><vargaH:nA><lifgam:puM><viBakwiH:3><vacanam:eka><level:1>
SuSrURasva	SrU1<upasarga:su><sanAxi_prawyayaH:san><prayogaH:karwari><lakAraH:lot><puruRaH:ma><vacanam:eka><paxI:parasmEpaxI><XAwuH:SrU><gaNaH:wanAxiH><level:1>
XArayan	XArayaw<vargaH:nA><lifgam:puM><viBakwiH:1><vacanam:eka>
XArayan	Xq1<kqw_prawyayaH:Sawq_lat><XAwuH:Xqf><gaNaH:BvAxiH>XArayaw<vargaH:nA><lifgam:puM><viBakwiH:1><vacanam:eka><level:1>
XArayiwvA	Xq1<vargaH:avy><sanAxi_prawyayaH:Nic><kqw_prawyayaH:kwvA><XAwuH:XqF><gaNaH:BvAxiH><level:1>
XAryawe	Xq1<sanAxi_prawyayaH:Nic><prayogaH:karmaNi><lakAraH:lat><puruRaH:pra><vacanam:eka><paxI:AwmanepaxI><XAwuH:XqF><gaNaH:BvAxiH><level:1>
XAvIwavAn	XAv1<sanAxi_prawyayaH:Nic><kqw_prawyayaH:kwavawu><XAwuH:XAvu><gaNaH:BAxiH><kqw_pratipadika:XAvIwavaw><vargaH:nA><lifgam:puM><viBakwiH:1><vacanam:eka><level:1>
XImahi	XA1<prayogaH:karwari><lakAraH:ASIrlif><puruRaH:u><vacanam:bahu><paxI:parasmEpaxI><gaNaH:juhowyAxiH><level:1>
XUrwawAm	XUrwawA<vargaH:nA><lifgam:swrI><viBakwiH:2><vacanam:eka><level:1>
XanavaxByaH	Xana<vargaH:nA><waxXiwa_prawyayaH:mawup><lifgam:puM><viBakwiH:4><vacanam:bahu><level:3>/Xana<vargaH:nA><waxXiwa_prawyayaH:mawup><lifgam:puM><viBakwiH:5><vacanam:bahu><level:3>/Xana<vargaH:nA><waxXiwa_prawyayaH:mawup><lifgam:napuM><viBakwiH:4><vacanam:bahu><level:3>/Xana<vargaH:nA><waxXiwa_prawyayaH:mawup><lifgam:napuM><viBakwiH:5><vacanam:bahu><level:3>
XanikaH	Xanika<vargaH:nA><lifgam:puM><viBakwiH:1><vacanam:eka><level:1>
Xanikasya	Xanika<vargaH:nA><lifgam:puM><viBakwiH:6><vacanam:eka><level:1>
XanuRmawA	XanuRmAn<vargaH:nA><lifgam:puM><viBakwiH:3><vacanam:eka><level:1>
Xuk	Xuk<vargaH:nA><lifgam:puM><viBakwiH:1><vacanam:eka>/Xuk<vargaH:nA><lifgam:swrI><viBakwiH:1><vacanam:eka><level:1>
aBiXIyawe	XA1<upasarga:aBi><prayogaH:karmaNi><lakAraH:lat><puruRaH:pra><vacanam:eka><paxI:AwmanepaxI><XAwuH:duXAF><gaNaH:juhowyAxiH>/XI1<upasarga:aBi><prayogaH:karwari><lakAraH:lat><puruRaH:pra><vacanam:eka><paxI:AwmanepaxI><XAwuH:XIf><gaNaH:xivAxiH><level:1>
aBijAwa	aBijAwa<vargaH:nA><lifgam:puM><viBakwiH:8><vacanam:eka><level:1>/<kqw_XAwu:jan3><upasarga:aBi><kqw_prawyayaH:kwa><XAwuH:janIz><gaNaH:xivAxiH>aBijAwa<vargaH:nA><lifgam:puM><viBakwiH:8><vacanam:eka><level:1>
aBikruXyawi	kruX1<upasarga:aBi><prayogaH:karwari><lakAraH:lat><puruRaH:pra><vacanam:eka><paxI:parasmEpaxI><XAwuH:kruXa><gaNaH:xivAxiH><level:1>
aBilaRanwI	aBilaRaw<vargaH:nA><lifgam:swrI><viBakwiH:1><vacanam:eka><level:1>
aBinanxyamAnA	aBinanxyamAnA<vargaH:nA><lifgam:swrI><viBakwiH:1><vacanam:eka><level:1>
aBiniviSawe	viS1<upasarga:aBi_ni><prayogaH:karwari><lakAraH:lat><puruRaH:pra><vacanam:eka><paxI:AwmanepaxI><XAwuH:viSaz><gaNaH:BvAxiH><level:1>
aBipUjayew	pUj1<upasarga:aBi><prayogaH:karwari><lakAraH:viXilif><puruRaH:pra><vacanam:eka><paxI:AwmanepaxI><XAwuH:pUjaz><gaNaH:curAxiH><level:1>
aBirunXanwi	ruX1<upasarga:aBi><prayogaH:karwari><lakAraH:lat><puruRaH:pra><vacanam:bahu><paxI:parasmEpaxI><XAwuH:ruXir><gaNaH:ruXAxiH><level:1>
aBivijvalanwi	jval1<upasarga:aBi_vi><prayogaH:karwari><lakAraH:lat><puruRaH:pra><vacanam:bahu><paxI:parasmEpaxI><XAwuH:jvalaz><gaNaH:BvAxiH><level:1>
aByasUyanwaH	aByasUyaw<vargaH:nA><lifgam:puM><viBakwiH:1><vacanam:bahu><level:1>
aByasUyawi	asUya<upasarga:aBi><prayogaH:karwari><lakAraH:lat><puruRaH:pra><vacanam:eka><paxI:parasmEpaxI><XAwuH:asUya><gaNaH:nAmaXAwu><level:1>
aKixyamAnaH	aKixyamAna<vargaH:nA><lifgam:puM><viBakwiH:1><vacanam:eka><level:1>
aMSumAn	aMSumaw<vargaH:nA><lifgam:puM><viBakwiH:1><vacanam:eka><level:1>
aRtaXA	aRtaXA<vargaH:avy><level:1>
aSanam	aSana<vargaH:nA><lifgam:napuM><viBakwiH:1><vacanam:eka><level:1>/aSana<vargaH:nA><lifgam:napuM><viBakwiH:2><vacanam:eka><level:1>/aSana<vargaH:nA><lifgam:puM><viBakwiH:2><vacanam:eka><level:1>
aXiRTAwum	RWA1<vargaH:avy><upasarga:aXi><kqw_prawyayaH:wumun><XAwuH:RWA><gaNaH:BvAxiH><level:1>
aXilaya	aXilaya<vargaH:nA><lifgam:puM><viBakwiH:8><vacanam:eka><level:1>
aXivApsIH	vAs1<upasarga:aXi><sanAxi_prawyayaH:Nic><prayogaH:karwari><lakAraH:lot><puruRaH:ma><vacanam:eka><paxI:parasmEpaxI><XAwuH:vAs><gaNaH:BvAxiH><level:1>
aXoXaH	aXoXa<vargaH:avy><waxXiwa_prawyayaH:asi><level:1>
afgIcakAra	kq3<upasarga:afgI><prayogaH:karwari><lakAraH:lit><puruRaH:pra><vacanam:eka><paxI:parasmEpaxI><gaNaH:kryAxiH><level:1>
afgIkqwvA	kq3<upasarga:afgI><vargaH:avy><kqw_prawyayaH:kwvA><XAwuH:dukq><gaNaH:wuwAxiH><level:1>
agawikAH	agawika<vargaH:nA><lifgam:puM><viBakwiH:1><vacanam:bahu><level:1>
ahafkqwaH	ahafkqwa<vargaH:nA><lifgam:puM><viBakwiH:1><vacanam:eka><level:1>
akAraH	akAra<vargaH:nA><lifgam:puM><viBakwiH:1><vacanam:eka><level:1>
ambum	ambu<vargaH:nA><lifgam:puM><viBakwiH:2><vacanam:eka><level:1>
amqwawvAya	amqwawva<vargaH:nA><lifgam:napuM><viBakwiH:4><vacanam:eka><level:1>
anasUyanwaH	anasUyaw<vargaH:nA><lifgam:puM><viBakwiH:1><vacanam:bahu><level:1>
anekaXA	anekaxA<vargaH:avy><level:1>
anuRTIwaH	RWA1<upasarga:anu><kqw_prawyayaH:kwa><XAwuH:RWA><gaNaH:BvAxiH>anuRTIwa<vargaH:nA><lifgam:puM><viBakwiH:1><vacanam:eka><level:1>
anuRTiwAw	anuRTiwa<vargaH:nA><lifgam:puM><viBakwiH:5><vacanam:eka><level:1>
anuRajjawe	sasj1<upasarga:anu><prayogaH:karwari><lakAraH:lat><puruRaH:pra><vacanam:eka><paxI:AwmanepaxI><XAwuH:Rasjaz><gaNaH:BvAxiH><level:1>
anuSuSruma	Sru1<upasarga:anu><prayogaH:karwari><lakAraH:lit><puruRaH:u><vacanam:bahu><paxI:parasmEpaxI><XAwuH:Sru><gaNaH:BvAxiH><level:1>
anuXAviwaH	XAv1<upasarga:anu><kqw_prawyayaH:kwa><XAwuH:XAvuz><gaNaH:BvAxiH><kqw_pratipadika:anuXAviwa><vargaH:nA><lifgam:puM><viBakwiH:1><vacanam:eka><level:1>
anubanXi	anubanXin<vargaH:nA><lifgam:napuM><viBakwiH:1><vacanam:eka><level:1>/anubanXin<vargaH:nA><lifgam:napuM><viBakwiH:2><vacanam:eka><level:1>/anubanXin<vargaH:nA><lifgam:puM><viBakwiH:8><vacanam:eka><level:1>
anubrUhi	brU1<upasarga:anu><prayogaH:karwari><lakAraH:lot><puruRaH:ma><vacanam:eka><paxI:parasmEpaxI><XAwuH:brUF><gaNaH:axAxiH><level:1>
anubuBURuH	BU1<upasarga:anu><sanAxi_prawyayaH:san><prayogaH:karwari><lakAraH:lit><puruRaH:pra><vacanam:bahu><paxI:parasmEpaxI><XAwuH:BU><gaNaH:BvAxiH><level:1>
anumAnya	man2<upasarga:anu><vargaH:avy><sanAxi_prawyayaH:Nic><kqw_prawyayaH:lyap><XAwuH:RaxL><gaNaH:wanAxiH><level:1>
anupakAriNe	anupakArin<vargaH:nA><lifgam:puM><viBakwiH:4><vacanam:eka><level:1>
anuprawimAx	anuprawima<vargaH:nA><lifgam:puM><viBakwiH:5><vacanam:eka><level:1>
anurajyawe	raFj2<upasarga:anu><prayogaH:BAve><lakAraH:lat><puruRaH:pra><vacanam:eka><paxI:AwmanepaxI><XAwuH:raFjaz><gaNaH:BvAxiH><level:1>
anusaMhqwiH	<kqw_XAwu:hq><upasarga:anu_sam><kqw_prawyayaH:kwin><XAwuH:hqF><gaNaH:BvAxiH>anusaMhqwi<vargaH:nA><lifgam:swrI><viBakwiH:2><vacanam:eka><level:1>
anuvarNayAmi	varN1<upasarga:anu><prayogaH:karwari><lakAraH:lat><puruRaH:u><vacanam:eka><paxI:parasmEpaxI><XAwuH:varNaz><gaNaH:curAxiH><level:1>
anuvarwayanwi	vqw3<upasarga:anu><prayogaH:karwari><lakAraH:lat><puruRaH:pra><vacanam:bahu><paxI:parasmEpaxI><XAwuH:vqwu><gaNaH:curAxiH><level:1>
anuvarwayawi	vqw1<upasarga:anu><sanAxi_prawyayaH:Nic><prayogaH:karwari><lakAraH:lat><puruRaH:pra><vacanam:eka><paxI:parasmEpaxI><XAwuH:vqwuz><gaNaH:BvAxiH><level:1>/vqw3<upasarga:anu><prayogaH:karwari><lakAraH:lat><puruRaH:pra><vacanam:eka><paxI:parasmEpaxI><XAwuH:vqwuz><gaNaH:curAxiH><level:1>
anuvarwiwavanwO	vqw1<upasarga:anu><kqw_prawyayaH:kwavawu><XAwuH:vqwuz><gaNaH:BvAxiH><kqw_pratipadika:anuvarwiwavaw><vargaH:nA><lifgam:puM><viBakwiH:1><vacanam:xvi><level:2>
anuviXIyawe	XA1<upasarga:anu_vi><prayogaH:karmaNi><lakAraH:lat><puruRaH:pra><vacanam:eka><paxI:AwmanepaxI><XAwuH:duXAF><gaNaH:juhowyAxiH><level:1>/XI1<upasarga:anu_vi><prayogaH:karwari><lakAraH:lat><puruRaH:pra><vacanam:eka><paxI:AwmanepaxI><XAwuH:XIf><gaNaH:xivAxiH><level:1>/XI1<upasarga:anu><prayogaH:karmaNi><lakAraH:lat><puruRaH:pra><vacanam:eka><paxI:AwmanepaxI><XAwuH:XIf><gaNaH:xivAxiH><level:1>/XI1<upasarga:anu><prayogaH:karmaNi><lakAraH:lat><puruRaH:pra><vacanam:eka><paxI:AwmanepaxI><XAwuH:Xi><gaNaH:wuxAxiH><level:1>
anuxarSayan	xqS1<upasarga:anu><kqw_prawyayaH:Sawq_lat><XAwuH:xqSizr><gaNaH:BvAxiH>anuxarSayaw<vargaH:nA><lifgam:puM><viBakwiH:1><vacanam:eka><level:1>
anvaSocaH	Suc1<upasarga:anu><prayogaH:karwari><lakAraH:laf><puruRaH:ma><vacanam:eka><paxI:parasmEpaxI><XAwuH:Sucaz><gaNaH:BvAxiH><level:1>
anvayufkwa	yuj1<upasarga:anu><prayogaH:karwari><lakAraH:laf><puruRaH:pra><vacanam:eka><paxI:parasmEpaxI><XAwuH:yuja><gaNaH:ruXAxiH><level:1>
anwarAwmanA	anwarAwman<vargaH:nA><lifgam:napuM><viBakwiH:3><vacanam:eka><level:1>
anyawaraw	anyawara<vargaH:nA><lifgam:napuM><viBakwiH:1><vacanam:eka><level:1>/anyawara<vargaH:nA><lifgam:napuM><viBakwiH:2><vacanam:eka><level:1>
apAwayan	paw1<sanAxi_prawyayaH:Nic><prayogaH:karwari><lakAraH:laf><puruRaH:pra><vacanam:bahu><paxI:parasmEpaxI><XAwuH:pawL><gaNaH:BvAxiH><level:1>
apaGAwe	apaGAwa<vargaH:nA><lifgam:puM><viBakwiH:7><vacanam:eka><level:1>
apahqwavAn	apahqwavaw<vargaH:nA><lifgam:puM><viBakwiH:1><vacanam:eka><level:1>
apamAnayawaH	mana1<upasarga:apa><prayogaH:karwari><lakAraH:lat><puruRaH:pra><vacanam:xvi><paxI:parasmEpaxI><XAwuH:mana><gaNaH:curAxiH><level:1>
apamAnayawi	mAna<upasarga:apa><sanAxi_prawyayaH:Nic><prayogaH:karwari><lakAraH:lat><puruRaH:pra><vacanam:eka><paxI:parasmEpaxI><XAwuH:mAna><gaNaH:curAxiH><level:1>
apanamawu	nam1<upasarga:apa><prayogaH:karwari><lakAraH:lot><puruRaH:pra><vacanam:eka><paxI:parasmEpaxI><XAwuH:Nam><gaNaH:BvAxiH><leve:0>
apekRaH	apekRaH<vargaH:nA><lifgam:puM><viBakwiH:1><vacanam:eka><level:1>
apoxXqwya	Xq<upasarga:apa_uw><vargaH:avy><kqw_prawyayaH:lyap><XAwuH:XqF><gaNaH:BvAxiH><level:1>
arisUxana	arisUxana<vargaH:nA><lifgam:puM><viBakwiH:8><vacanam:eka><level:1>
arpayiwum	q1<vargaH:avy><sanAxi_prawyayaH:Nic><kqw_prawyayaH:wumun><XAwuH:q><gaNaH:BvAxiH><level:2>
asUyAmi	asUya<prayogaH:karwari><lakAraH:lat><puruRaH:u><vacanam:eka><paxI:parasmEpaxI><gaNaH:nAmaXAwu><level:1>
asUyan	asU<kqw_prawyayaH:Sawq_lat><lifgam:puM><XAwuH:asU><gaNaH:kaNdvAxi><level:0>
asUyanwi	asUya<prayogaH:karwari><lakAraH:lat><puruRaH:pra><vacanam:eka><paxI:parasmEpaxI><gaNaH:nAmaXAwu><level:1>
asUyawi	asUya<prayogaH:karwari><lakAraH:lat><puruRaH:pra><vacanam:eka><paxI:parasmEpaxI><gaNaH:nAma><level:1>
avAc	avAc<vargaH:nA><lifgam:swrI><viBakwiH:1><vacanam:eka><level:1>
avaH	avara<vargaH:avy><waxXiwa_prawyayaH:asi><level:1>
avaRtaBya	RwaB1<upasarga:ava><vargaH:avy><kqw_prawyayaH:lyap><XAwuH:RtaBiz><gaNaH:BvAxiH><level:1>
avaXAryawAm	Xq1<upasarga:ava><prayogaH:karwari><lakAraH:viXilif><puruRaH:pra><vacanam:xvi><paxI:uBayapaxI><XAwuH:XqF><gaNaH:BvAxiH><level:1
avacinowi	ci1<upasarga:ava><prayogaH:karwari><lakAraH:lat><puruRaH:pra><vacanam:eka><paxI:parasmEpaxI><XAwuH:ciF><gaNaH:wanAxiH><level:1>
avalokayan	avalokayaw<vargaH:nA><lifgam:puM><viBakwiH:1><vacanam:eka><level:1>
avanamayya	nam1<upasarga:ava><sanAxi_prawyayaH:Nic><vargaH:avy><kqw_prawyayaH:lyap><XAwuH:nam><gaNaH:BvAxiH><level:1>
avaraswAw	avara<vargaH:avy><waxXiwa_prawyayaH:aswAwi><level:1>
avasAxayew	sax1<upasarga:ava><sanAxi_prawyayaH:Nic><prayogaH:karwari><lakAraH:viXilif><puruRaH:pra><vacanam:eka><paxI:parasmEpaxI><XAwuH:RaxLz><gaNaH:BvAxiH><level:1>
avasWApya	RWA1<upasarga:ava><vargaH:avy><sanAxi_prawyayaH:Nic><kqw_prawyayaH:lyap><XAwuH:RWA><gaNaH:BvAxiH><level:1>
avaswAw	avara<vargaH:avy><waxXiwa_prawyayaH:aswAwi><level:1>
avawiRTawe	RWA1<upasarga:ava><prayogaH:karwari><lakAraH:lat><puruRaH:pra><vacanam:eka><paxI:AwmanepaxI><XAwuH:viSaz><gaNaH:BvAxiH><level:1>
avinASi	avinASin<vargaH:nA><lifgam:napuM><viBakwiH:1><vacanam:eka><level:1>/avinASin<vargaH:nA><lifgam:napuM><viBakwiH:2><vacanam:eka><level:1>
awiricyawe	ric1<upasarga:awi><prayogaH:karmaNi><lakAraH:lat><puruRaH:pra><vacanam:eka><paxI:AwmanepaxI><XAwuH:ricizr><gaNaH:ruXAxiH><level:1>
awyAcaranwi	car1<upasarga:awi_Af><prayogaH:karwari><lakAraH:lat><puruRaH:pra><vacanam:bahu><paxI:parasmEpaxI><XAwuH:cara><gaNaH:BvAxiH><level:1>
awyucCriwam	awyucCriwa<vargaH:nA><lifgam:napuM><viBakwiH:1><vacanam:eka><level:1>/awyucCriwa<vargaH:nA><lifgam:napuM><viBakwiH:2><vacanam:eka><level:1>/awyucCriwa<vargaH:nA><lifgam:puM><viBakwiH:2><vacanam:eka><level:1>
axqSyamanaH	axqSyaman<vargaH:nA><lifgam:puM><viBakwiH:1><vacanam:eka><level:1>
axyawve	axya<vargaH:avy><waxXiwa_prawyayaH:wva><level:1>
ayaNam	ayaNa<vargaH:nA><lifgam:napuM><viBakwiH:1><vacanam:eka><level:1>
balavawAm	balavaw<vargaH:nA><lifgam:puM><viBakwiH:6><vacanam:bahu><level:1>
banXakawvam	banXakawva<vargaH:nA><lifgam:napuM><viBakwiH:1><vacanam:eka><level:1>/banXakawva<vargaH:nA><lifgam:napuM><viBakwiH:2><vacanam:eka><level:1>
baxXaH	banX1<kqw_prawyayaH:kwa><XAwuH:banXaz><gaNaH:kryAxiH><kqw_pratipadika:baxXa><vargaH:nA><lifgam:puM><viBakwiH:1><vacanam:eka><level:1>
baxXam	banX1<kqw_prawyayaH:kwa><XAwuH:banXaz><gaNaH:kryAxiH><kqw_pratipadika:baxXa><lifgam:puM><viBakwiH:2><vacanam:eka><level:1>
baxXvA	banX1<vargaH:avy><kqw_prawyayaH:kwvA><XAwuH:baXaz><gaNaH:krAxiH><level:1>
biBIRaNaH	biBIRaNa<vargaH:nA><lifgam:puM><viBakwiH:1><vacanam:eka><level:1>
biBIRaNam	biBIRaNa<vargaH:nA><lifgam:puM><viBakwiH:2><vacanam:eka><level:1>
biBIRaNasya	biBIRaNa<vargaH:nA><lifgam:puM><viBakwiH:6><vacanam:eka><level:1>
biByawIm	biByaw<vargaH:nA><lifgam:napuM><viBakwiH:1><vacanam:eka><level:1>
boXayanwaH	buX2<upasarga:X><kqw_prawyayaH:Sawq_lat><XAwuH:buXizr><gaNaH:BvAxiH>boXayaw<vargaH:nA><lifgam:puM><viBakwiH:1><vacanam:bahu><level:1>/buX1<upasarga:X><kqw_prawyayaH:Sawq_lat><XAwuH:buXaz><gaNaH:BvAxiH>boXayaw<vargaH:nA><lifgam:puM><viBakwiH:1><vacanam:bahu><level:1>
boXiwavAn	buX1<kqw_prawyayaH:kwavawu><XAwuH:buXa><gaNaH:BvAxiH><kqw_pratipadika:boXiwavaw><vargaH:nA><lifgam:puM><viBakwiH:1><vacanam:eka><level:1>
boXiwavawI	buX1<kqw_prawyayaH:kwavawu><XAwuH:buXa><gaNaH:BvAxiH><kqw_pratipadika:boXiwavaw><vargaH:nA><lifgam:swrI><viBakwiH:1><vacanam:eka><level:1>
bqhawsPik	bqhawsPik<vargaH:nA><lifgam:swrI><viBakwiH:1><vacanam:eka><level:1>
buxXimawAm	buxXimaw<vargaH:nA><lifgam:puM><viBakwiH:6><vacanam:bahu><level:1>
buxXvA	buX1<vargaH:avy><kqw_prawyayaH:kwvA><XAwuH:buXir><ganaH:BvAxiH>/buX3<vargaH:avy><kqw_prawyayaH:kwvA><XAwuH:buXaz><gaNaH:xivAxiH><level:1>
cEva	cEva<vargaH:avy><level:1>
cIwkarowi	kq3<upasarga:cIw><prayogaH:karwari><lakAraH:lat><puruRaH:pra><vacanam:eka><paxI:parasmEpaxI><XAwuH:dukqF><gaNaH:wanAxiH><level:1>
cUrNiwE	cUrNiwa<vargaH:nA><lifgam:puM><viBakwiH:3><vacanam:bahu><level:1>
camU	camU<vargaH:nA><lifgam:swrI><viBakwiH:1><vacanam:eka><level:1>
cikIrRuH	kq1<sanAxi_prawyayaH:san><kqw_prawyayaH:u><XAwuH:dukqF><gaNaH:wanAxiH><kqw_pratipadika:cikIrRu><lifgam:puM><viBakwiH:1><vacanam:eka><level:1>
ciraFjIviwam	ciraFjIviwa<vargaH:nA><lifgam:napuM><viBakwiH:1><vacanam:eka><level:1>
cyavanwi	cyu1<prayogaH:karwari><lakAraH:lat><puruRaH:pra><vacanam:bahu><paxI:parasmEpaxI><gaNaH:BvAxiH><level:1>
ekawvena	ekawva<vargaH:nA><lifgam:napuM><viBakwiH:3><vacanam:eka><level:1>
eke	eka<vargaH:nA><lifgam:puM><viBakwiH:1><vacanam:bahu><level:1>
gAnXI	gAnXI<vargaH:nA><lifgam:puM><viBakwiH:1><vacanam:eka><level:1>
gAyamAnO	gAyamAna<vargaH:nA><lifgam:puM><viBakwiH:1><vacanam:xvi><level:1>
gamiRyanwaH	gamiRyaw<vargaH:nA><lifgam:puM><viBakwiH:1><vacanam:bahu><level:1>
garvase	garv1<prayogaH:karwari><lakAraH:lat><puruRaH:ma><vacanam:eka><paxI:parasmEpaxI><gaNaH:BvAxiH><level:1>
gopAla	gopAla<vargaH:nA><lifgam:puM><viBakwiH:8><vacanam:eka><level:1>
govinxa	govinxa<vargaH:nA><lifgam:puM><viBakwiH:8><vacanam:eka><level:1>
gqhIwvA	gqh1<vargaH:avy><kqw_prawyayaH:kwvA><XAwuH:gqhU><gaNaH:BvAxiH><level:1>/grah1<vargaH:avy><kqw_prawyayaH:kwvA><XAwuH:grahaz><gaNaH:kryAxiH><level:1>
gqhiNaH	gqhin<vargaH:nA><lifgam:puM><viBakwiH:1><vacanam:bahu><level:1>
grahaNena	grahaNa<vargaH:nA><lifgam:puM><viBakwiH:3><vacanam:eka><level:1>
gudAkeSa	gudAkeSa<vargaH:nA><lifgam:puM><viBakwiH:8><vacanam:eka><level:1>
guhyawamam	guhyawama<vargaH:nA><lifgam:napuM><viBakwiH:2><vacanam:eka><level:1>
gurutvena	gurutva<vargaH:nA><lifgam:napuM><viBakwiH:3><vacanam:eka><level:1>
hArayiRyan	hq1<upasarga:X><sanAxi_prawyayaH:Nic><kqw_prawyayaH:Sawq_lqt><XAwuH:hq><gaNaH:BvAxiH>hArayiRyaw<vargaH:nA><lifgam:puM><viBakwiH:1><vacanam:eka><level:1>
hanumawA	hanumaw<vargaH:nA><lifgam:puM><viBakwiH:3><vacanam:eka><level:1>
haswikayA	haswikA<vargaH:nA><lifgam:swrI><viBakwiH:3><vacanam:eka><level:1>
havyavAt	havyavah<vargaH:nA><lifgam:puM><viBakwiH:1><vacanam:eka><level:1>
hqRIkeSa	hqRIkeSa<vargaH:nA><lifgam:puM><viBakwiH:8><vacanam:eka><level:1>
husEnam	husEna<vargaH:nA><lifgam:puM><viBakwiH:2><vacanam:eka><level:1>
icCukaH	icCuka<vargaH:nA><lifgam:puM><viBakwiH:1><vacanam:eka><level:1>
ifgawe	ifg1<prayogaH:karwari><lakAraH:lat><puruRaH:pra><vacanam:eka><paxI:AwmanepaxI><gaNaH:BvAxiH><level:1>
iwyAxayaH	iwyAxi<vargaH:nA><lifgam:swrI><viBakwiH:3><vacanam:bahu><level:1>
iyAn	iyaw<vargaH:nA><lifgam:puM><viBakwiH:1><vacanam:eka><level:1>
jAgarayanwI	jAgq1<sanAxi_prawyayaH:Nic><prayogaH:karwari><lakAraH:lat><puruRaH:pra><vacanam:bahu><paxI:parasmEpaxI><XAwuH:jAgq><gaNaH:juhowyAxiH><level:1>/jAgarayanwI<vargaH:nA><lifgam:swrI><viBakwiH:1><vacanam:eka><level:1>
jAgrawi	jAgq1<prayogaH:karwari><lakAraH:lat><puruRaH:pra><vacanam:bahu><paxI:parasmEpaxI><XAwuH:jAgq><gaNaH:juhowyAxiH><level:1>
jAjvalyamAnA	jAjvalyamAnA<vargaH:nA><lifgam:swrI><viBakwiH:1><vacanam:eka><level:1>
jAnan	jAnaw<vargaH:nA><lifgam:puM><viBakwiH:1><vacanam:eka><level:1>
jAnanwaH	jAnaw<vargaH:nA><lifgam:puM><viBakwiH:1><vacanam:bahu><level:1>
jAne	jFA1<prayogaH:karwari><lakAraH:lat><puruRaH:u><vacanam:eka><paxI:AwmanepaxI><gaNaH:kryAxiH><level:1>
jFAnavawAm	jFAnavaw<vargaH:nA><lifgam:puM><viBakwiH:6><vacanam:bahu><level:1>
jIrNAni	jIrNa<vargaH:nA><lifgam:napuM><viBakwiH:2><vacanam:bahu><level:1>
janayan	jan2<sanAxi_prawyayaH:Nic><kqw_prawyayaH:Sawq_lat><XAwuH:janI><gaNaH:xivAxiH>janayaw<vargaH:nA><lifgam:puM><viBakwiH:1><vacanam:eka><level:1>
jatAyuRam	jatAyus<vargaH:nA><lifgam:puM><viBakwiH:2><vacanam:eka><level:1>
jigIRawAm	jigIRaw<vargaH:nA><lifgam:puM><viBakwiH:6><vacanam:bahu><level:1>
jijFAsawe	jFA1<sanAxi_prawyayaH:san><prayogaH:karwari><lakAraH:lat><puruRaH:pra><vacanam:eka><paxI:parasmEpaxI><XAwuH:jan><gaNaH:kryAxiH><level:1>
jijFAsiwavAn	jijFAsiwavaw<vargaH:nA><lifgam:puM><viBakwiH:1><vacanam:eka><level:1>
jijIviRAmaH	jIv1<sanAxi_prawyayaH:san><prayogaH:karwari><lakAraH:lat><puruRaH:u><vacanam:bahu><paxI:parasmEpaxI><XAwuH:jIvaz><gaNaH:BvAxiH><level:1>
kANAxam	kANAxa<vargaH:nA><lifgam:napuM><viBakwiH:1><vacanam:eka><level:1>
kAfkRe	kAkR1<prayogaH:karwari><lakAraH:lat><puruRaH:u><vacanam:eka><paxI:AwmanepaxI><gaNaH:BvAxiH><level:1>
kArayan	kArayaw<vargaH:nA><lifgam:puM><viBakwiH:1><vacanam:eka><level:1>
kArayanwaH	kArayaw<vargaH:nA><lifgam:puM><viBakwiH:1><vacanam:bahu><level:1>
kArayiwum	kq1<vargaH:avy><sanAxi_prawyayaH:Nic><kqw_prawyayaH:wumun><XAwuH:dukqF><gaNaH:wanAxiH><level:1>
kArayiwvA	kq1<vargaH:avy><sanAxi_prawyayaH:Nic><kqw_prawyayaH:kwvA><XAwuH:dukrIF><gaNaH:wanAxiH><level:1>
kAriwaH	kq1<vargaH:nA><sanAxi_prawyayaH:Nic><kqw_prawyayaH:kwa><XAwuH:kq1><gaNaH:wanAxiH><lifgam:puM><viBakwiH:1><vacanam:eka><level:1>
kAriwavAn	kAriwavaw<vargaH:nA><lifgam:puM><viBakwiH:1><vacanam:eka><level:1>
kAriwavawI	kAriwavawI<vargaH:nA><lifgam:swrI><viBakwiH:1><vacanam:eka><level:1>
kAryawe	kq1<sanAxi_prawyayaH:Nic><prayogaH:karmaNi><lakAraH:lat><puruRaH:pra><vacanam:eka><paxI:AwmanepaxI><XAwuH:dukqF><gaNaH:wanAxiH><level:2>
kAvyawvam	kAvyawva<vargaH:nA><lifgam:napuM><viBakwiH:1><vacanam:eka><level:1>/kAvyawva<vargaH:nA><lifgam:napuM><viBakwiH:2><vacanam:eka><level:1>
kIrwiwAH	<kqw_XAwu:kIrw1><upasarga:X><kqw_prawyayaH:kwa><XAwuH:kIrwaz><gaNaH:BvAxiH>kIrwiwa<vargaH:nA><lifgam:puM><viBakwiH:1><vacanam:bahu><level:1>
kUrxanwi	kurx1<prayogaH:karwari><lakAraH:lat><puruRaH:pra><vacanam:bahu><paxI:parasmEpaxI><gaNaH:xivAxiH><level:1>
kalApavawIm	kalApavawI<vargaH:nA><lifgam:swrI><viBakwiH:2><vacanam:eka><level:1>
karaBakaH	karaBaka<vargaH:nA><lifgam:puM><viBakwiH:1><vacanam:eka><level:1>
karmANam	karman<vargaH:nA><lifgam:puM><viBakwiH:2><vacanam:eka><level:1>
karmacAriNI	karmcAriNI<vargaH:nA><lifgam:swrI><viBakwiH:1><vacanam:eka><level:1>
kawaraw	kawaraw<vargaH:nA><lifgam:napuM><viBakwiH:1><vacanam:eka><level:1>
kiMvA	kiMvA<vargaH:avy><level:1>
klibiREH	kilbiRa<vargaH:nA><lifgam:puM><viBakwiH:3><vacanam:bahu><level:1>
kqRiwaH	kqRi<vargaH:avy><waxXiwa_prawyayaH:wasil><level:1>
kqpaH	kqpa<vargaH:nA><lifgam:puM><viBakwiH:1><vacanam:eka><level:1>
kqwavanwAn	kqwavaw<vargaH:nA><lifgam:puM><viBakwiH:1><vacanam:bahu><level:1>
krIdanAya	krIdanam<vargaH:nA><lifgam:napuM><viBakwiH:4><vacanam:eka><level:1>
kriyamANAni	kriyamANa<vargaH:nA><lifgam:napuM><viBakwiH:1><vacanam:bahu><level:1>/kriyamANa<vargaH:nA><lifgam:napuM><viBakwiH:2><vacanam:bahu><level:1>
kuNdalinIm	kuNdalinI<vargaH:nA><lifgam:swrI><viBakwiH:2><vacanam:eka><level:1>
kvaWikAm	kvaWikA<vargaH:nA><lifgam:swrI><viBakwiH:2><vacanam:eka><level:1>
laBew	laB1<prayogaH:karwari><lakAraH:viXilif><puruRaH:pra><vacanam:eka><paxI:parasmEpaxI><gaNaH:BvAxiH><level:1>
laGupawanakAya	laGupawanaka<vargaH:nA><lifgam:puM><viBakwiH:4><vacanam:eka><level:1>
laGupawanaka	laGupawanaka<vargaH:nA><lifgam:puM><viBakwiH:8><vacanam:eka><level:1>
laGupawanakaH	laGupawanaka<vargaH:nA><lifgam:puM><viBakwiH:1><vacanam:eka><level:1>
laGupawanakasya	laGupawanaka<vargaH:nA><lifgam:puM><viBakwiH:6><vacanam:eka><level:1>
leKayiwum	liK1<vargaH:avy><sanAxi_prawyayaH:Nic><kqw_prawyayaH:wumun><XAwuH:liKa><gaNaH:wuxAxiH><level:1>
leKayiwvA	liK1<vargaH:avy><sanAxi_prawyayaH:Nic><kqw_prawyayaH:kwvA><XAwuH:liKa><gaNaH:wuxAxiH><level:1>
lelihyase	lih1<sanAxi_prawyayaH:yaf><prayogaH:karwari><lakAraH:lat><puruRaH:ma><vacanam:eka><paxI:AwmanepaxI><gaNaH:axAxiH><level:1>
mAnaxa	mAnaxa<vargaH:nA><lifgam:puM><viBakwiH:8><vacanam:eka><level:1>/mAnaxa<vargaH:nA><lifgam:napuM><viBakwiH:8><vacanam:eka><level:1>
mArayiwum	mq1<vargaH:avy><sanAxi_prawyayaH:Nic><kqw_prawyayaH:wumun><XAwuH:mqf><gaNaH:wuxAxiH><level:1>
mArayiwvA	mq1<vargaH:avy><sanAxi_prawyayaH:Nic><kqw_prawyayaH:kwvA><XAwuH:mq><gaNaH:wuxAxiH><level:1>
mArgamANaH	mArg1<kqw_prawyayaH:SAnac_lat><XAwuH:mArga><gaNaH:curAxiH><kqw_pratipadika:mArgamANa><vargaH:nA><lifgam:puM><viBakwiH:1><vacanam:eka><level:1>
mUrXni	mUrXna<vargaH:nA><lifgam:napuM><viBakwiH:7><vacanam:eka><level:1>
mUrwinA	mUrwi<vargaH:nA><lifgam:puM><viBakwiH:3><vacanam:eka><level:1>
mahABAga	mahABAga<vargaH:nA><lifgam:puM><viBakwiH:8><vacanam:eka><level:1>
mahArAja	mahArAja<vargaH:nA><lifgam:puM><viBakwiH:8><vacanam:eka><level:1>
mahIyawe	mahI<upasarga:X><prayogaH:karwari><lakAraH:lat><puruRaH:pra><vacanam:eka><paxI:AwmanepaxI><XAwuH:mahI><gaNaH:nAmaXawu><level:1>
mahilAropyam	mahilAropya<vargaH:nA><lifgam:napuM><viBakwiH:1><vacanam:eka><level:1>
mamaH	mama<vargaH:nA><lifgam:puM><viBakwiH:1><vacanam:eka><level:1>
manwavyaH	man1<vargaH:nA><kqw_prawyayaH:wavyaw><XAwuH:manaz><gaNaH:xivAxiH><lifgam:puM><viBakwiH:1><vacanam:eka><level:1>
marRayan	mqR1<sanAxi_prawyayaH:Nic><kqw_prawyayaH:Sawq_lat><XAwuH:mqRaz><gaNaH:BvAxiH>marRayaw<vargaH:nA><lifgam:puM><viBakwiH:1><vacanam:eka><level:1>
marxayiwum	mqx1<vargaH:avy><sanAxi_prawyayaH:Nic><kqw_prawyayaH:wumun><XAwuH:mqxaz><gaNaH:kryAxiH><level:1>
meXasAm	meXas<vargaH:nA><lifgam:napuM><viBakwiH:6><vacanam:bahu><level:1>
miRtAnnavyavasAyI	miRtAnnavyavasAyin<vargaH:nA><lifgam:puM><viBakwiH:1><vacanam:eka><level:1>
mohiwam	muh<kqw_prawyayaH:kwa><XAwuH:muhaz><gaNaH:xivAxiH><vargaH:nA><lifgam:puM><viBakwiH:2><vacanam:eka><level:1>/mohiwa<kqw_prawyayaH:kwa><XAwuH:muhaz><gaNaH:xivAxiH><vargaH:nA><lifgam:napuM><viBakwiH:1><vacanam:eka><level:1>/muhiwa<kqw_prawyayaH:kwa><XAwuH:muhaz><gaNaH:xivAxiH><vargaH:nA><lifgam:napuM><viBakwiH:2><vacanam:eka><level:1>
muhammaxaH	muhammaxa<vargaH:nA><lifgam:puM><viBakwiH:1><vacanam:eka><level:1>
muhurmuhuH	muhurmuhuH<vargaH:avy><level:1>
mumoxa	mux1<prayogaH:karwari><lakAraH:lit><puruRaH:pra><vacanam:eka><paxI:parasmEpaxI><gaNaH:BvAxiH><level:1>
nASAya	naS1<kqw_prawyayaH:GaF><XAwuH:NaSaz><gaNaH:xivAxiH>nASa<vargaH:nA><lifgam:puM><viBakwiH:4><vacanam:eka><level:1>/naS1<sanAxi_prawyayaH:Nic><kqw_prawyayaH:GaF><XAwuH:NaSaz><gaNaH:xivAxiH>nASa<vargaH:nA><lifgam:puM><viBakwiH:4><vacanam:eka><level:1>
nASa	naS1<kqw_prawyayaH:GaF><XAwuH:NaSaz><gaNaH:xivAxiH>nASa<vargaH:nA><lifgam:puM><viBakwiH:8><vacanam:eka><level:2>
nASiwam	NaS1<sanAxi_prawyayaH:Nic><kqw_prawyayaH:kwa><XAwuH:NaSaz><gaNaH:xivAxiH>nASiwa<vargaH:nA><lifgam:puM><viBakwiH:2><vacanam:eka><level:1>/NaS1<sanAxi_prawyayaH:Nic><kqw_prawyayaH:kwa><XAwuH:NaSaz><gaNaH:xivAxiH>nASiwa<vargaH:nA><lifgam:napuM><viBakwiH:1><vacanam:eka><level:1>/NaS1<sanAxi_prawyayaH:Nic><kqw_prawyayaH:kwa><XAwuH:NaSaz><gaNaH:xivAxiH>nASiwa<vargaH:nA><lifgam:napuM><viBakwiH:2><vacanam:eka><level:1>
namasyanwaH	namasyaw<vargaH:nA><lifgam:puM><viBakwiH:1><vacanam:bahu><level:1>
nanxana	nanxana<vargaH:nA><lifgam:puM><viBakwiH:8><vacanam:eka><level:1>
narAXamAn	narAXama<vargaH:nA><lifgam:puM><viBakwiH:2><vacanam:bahu><level:1>
niHsArayawu	sru1<upasarga:ni><sanAxi_prawyayaH:Nic><prayogaH:karwari><lakAraH:lot><puruRaH:pra><vacanam:eka><paxI:parasmEpaxI><XAwuH:sru><gaNaH:BvAxiH><level:1>
niRIxawam	Rax1<upasarga:ni><prayogaH:karwari><lakAraH:lot><puruRaH:ma><vacanam:xvi><paxI:parasmEpaxI><XAwuH:RaxLz><gaNaH:BvAxiH><level:1>
niRTiwaH	RWA1<upasarga:ni><kqw_prawyayaH:kwa><XAwuH:RWA1><gaNaH:BvAxiH><kqw_pratipadika:niRTiwa><vargaH:nA><lifgam:puM><viBakwiH:1><vacanam:eka><level:1>
niRkAsya	kAs1<upasarga:nis><vargaH:avy><kqw_prawyayaH:lyap><XAwuH:kAsqz><gaNaH:BvAxiH><level:1>
niScarawi	car1<upasarga:ni><prayogaH:karwari><lakAraH:lat><puruRaH:pra><vacanam:eka><paxI:parasmEpaxI><XAwuH:caraz><gaNaH:BvAxiH><level:1>/car1<upasarga:nis><prayogaH:karwari><lakAraH:lat><puruRaH:pra><vacanam:eka><paxI:parasmEpaxI><XAwuH:caraz><gaNaH:BvAxiH><level:1>
niSciwavAn	ci1<upasarga:niH><kqw_prawyayaH:kwavawu><XAwuH:ci><gaNaH:curAxiH><kqw_pratipadika:niSciwavaw><vargaH:nA><lifgam:puM><viBakwiH:1><vacanam:eka><level:1>
nibarhaNaH	nibarhaNa<vargaH:nA><lifgam:puM><viBakwiH:1><vacanam:eka><level:1>
nigrAhayiRyAmi	grah1<upasarga:ni><sanAxi_prawyayaH:Nic><prayogaH:karwari><lakAraH:lrit><puruRaH:u><vacanam:eka><paxI:parasmEpaxI><XAwuH:graha><gaNaH:kryAxiH><level:1>
nihawAH	nihawa<vargaH:nA><lifgam:puM><viBakwiH:1><vacanam:bahu><level:1>
nijaGAna	han1<upasarga:ni><prayogaH:karwari><lakAraH:lit><puruRaH:pra><vacanam:eka><paxI:parasmEpaxI><XAwuH:hanaz><gaNaH:axAxiH><level:1>
nimanwriwavAn	nimanwriwavaw<vargaH:nA><lifgam:puM><viBakwiH:1><vacanam:eka><level:1>
nipAwayawi	paw1<upasarga:ni><sanAxi_prawyayaH:Nic><prayogaH:karwari><lakAraH:lat><puruRaH:pra><vacanam:eka><paxI:parasmEpaxI><XAwuH:paw><gaNaH:BvAdiH><level:1>
nipAwinaH	nipAwin<vargaH:nA><lifgam:puM><viBakwiH:1><vacanam:bahu><level:1>
nipawiwaH	nipawiwa<vargaH:nA><lifgam:puM><viBakwiH:1><vacanam:eka><level:1>
niprahanyuH	han1<upasarga:ni_pra><prayogaH:karwari><lakAraH:viXilif><puruRaH:pra><vacanam:bahu><paxI:parasmEpaxI><XAwuH:han><gaNaH:axAxiH><level:1>
nirASIH	nirASis<vargaH:nA><lifgam:puM><viBakwiH:1><vacanam:eka><level:1>
nirAkqwavAn	kq3<upasarga:nirA><kqw_prawyayaH:kwavawu><XAwuH:dukqF><gaNaH:wanAxiH><kqw_pratipadika:nirAkqwavaw><vargaH:nA><lifgam:puM><viBakwiH:1><vacanam:eka><level:1>
nirAsWaw	RWA1<upasarga:nir><prayogaH:karwari><lakAraH:luf><puruRaH:pra><vacanam:eka><paxI:AwmanepaxI><XAwuH:RWA><gaNaH:BvAxiH><level:1>
nirIkRyam	IkR1<upasarga:nir><kqw_prawyayaH:yaw><XAwuH:IkRaz><gaNaH:BvAxiH><kqw_pratipadika:nirIkRya><vargaH:nA><lifgam:puM><viBakwiH:2><vacanam:eka><level:1>
nirNIyawe	NI1<upasarga:nir><prayogaH:karwari><lakAraH:lat><puruRaH:pra><vacanam:eka><paxI:AwmanepaxI><XAwuH:NIF><gaNaH:BvAxiH><level:1>
niragcCat	gam1<upasarga:nir><prayogaH:karwari><lakAraH:laf><puruRaH:pra><vacanam:eka><paxI:parasmEpaxI><XAwuH:gamLz><gaNaH:BvAxiH><level:1>
nirgawAH	<kqw_XAwu:gam1><upasarga:nir><kqw_prawyayaH:kwa><XAwuH:gamLz><gaNaH:BvAxiH>nirgawa<vargaH:nA><lifgam:puM><viBakwiH:1><vacanam:bahu><level:1>
nirmApiwavAn	nirmApiwavaw<vargaH:nA><lifgam:puM><viBakwiH:1><vacanam:eka><level:1>
nirmApiwavawI	nirmApiwavawI<vargaH:nA><lifgam:swrI><viBakwiH:1><vacanam:eka><level:1>
nirmamaH	nirmama<vargaH:nA><lifgam:puM><viBakwiH:1><vacanam:eka><level:1>
niruxXa	ruX1<upasarga:ni><kqw_prawyayaH:kwa><XAwuH:ruXizr><gaNaH:ruXAxiH>niruxXa<vargaH:nA><lifgam:puM><viBakwiH:8><vacanam:eka><level:1>
nirvAsayiRyawi	vas4<upasarga:ni><prayogaH:karwari><lakAraH:lrit><puruRaH:u><vacanam:eka><paxI:parasmEpaxI><XAwuH:vasaz><gaNaH:curAxiH><level:1>
nirvAsayiSyawi	vasa1<upasarga:ni><sanAxi_prawyayaH:Nic><prayogaH:karwari><lakAraH:lat><puruRaH:pra><vacanam:eka><paxI:parasmEpaxI><XAwuH:vasa><gaNaH:BvAxiH><level:1>
nirvarwiwavanwO	vqw1<upasarga:nir><kqw_prawyayaH:kwavawu><XAwuH:vqwuz><gaNaH:BvAxiH><kqw_pratipadika:nirvarwiwavaw><vargaH:nA><lifgam:puM><viBakwiH:1><vacanam:xvi><level:1>
nirxaSAnanAni	nirxaSanana<vargaH:nA><lifgam:napuM><viBakwiH:1><vacanam:bahu><level:1>
nirxeSyam	nirxeSya<vargaH:nA><lifgam:napuM><viBakwiH:2><vacanam:eka><level:1>
nivAraNIyaH	vq1<vargaH:nA><sanAxi_prawyayaH:Nic><kqw_prawyayaH:anIyar><XAwuH:vq><gaNaH:BvAxiH><lifgam:puM><viBakwiH:1><vacanam:eka><level:1>
nivArayan	nivArayaw<vargaH:nA><lifgam:puM><viBakwiH:1><vacanam:eka><level:1>
nivarwanwe	vqw1<upasarga:ni><prayogaH:karwari><lakAraH:lat><puruRaH:pra><vacanam:bahu><paxI:AwmanepaxI><XAwuH:vqwuz><gaNaH:BvAxiH><level:1>
nivarwawe	vqw1<upasarga:ni><prayogaH:karwari><lakAraH:lat><puruRaH:pra><vacanam:eka><paxI:AwmanepaxI><XAwuH:vqwuz><gaNaH:BvAxiH><level:1>
nivarwayAmAsa	vqw1<upasarga:ni><prayogaH:karwari><lakAraH:lit><puruRaH:pra><vacanam:eka><paxI:parasmEpaxI><XAwuH:vqwu><gaNaH:BvAxiH><level:1>
nivarwaya	vqw1<upasarga:ni><prayogaH:karwari><lakAraH:lot><puruRaH:ma><vacanam:eka><paxI:parasmEpaxI><XAwuH:vqwu><gaNaH:BvAxiH><level:1>
nivarwwya	vqw1<upasarga:ni><prayogaH:karwari><lakAraH:lot><puruRaH:ma><vacanam:eka><paxI:parasmEpaxI><XAwuH:vqwu><gaNaH:BvAxiH><level:1>
nivasiRyasi	vas<upasarga:ni><prayogaH:karwari><lakAraH:lqt><puruRaH:ma><vacanam:eka><paxI:parasmEpaxI><XAwuH:vasaz><gaNaH:BvAxiH><level:1>
niveSaya	viS1<upasarga:ni><sanAxi_prawyayaH:Nic><prayogaH:karwari><lakAraH:lat><puruRaH:ma><vacanam:eka><paxI:parasmEpaxI><XAwuH:viSaz><gaNaH:wuxAxiH><level:1>
niveSiwA	viS1<upasarga:ni><sanAxi_prawyayaH:Nic><kqw_prawyayaH:kwa><XAwuH:viSaz><gaNaH:BvAxiH><kqw_pratipadika:niveSiwA><vargaH:nA><lifgam:swrI><viBakwiH:1><vacanam:eka><level:1>
nivexayAmi	vix3<upasarga:ni><prayogaH:karwari><lakAraH:lat><puruRaH:u><vacanam:eka><paxI:parasmEpaxI><XAwuH:vixa><gaNaH:curAxiH><level:1>
nivexaya	vix5<upasarga:ni><prayogaH:karwari><lakAraH:lot><puruRaH:ma><vacanam:eka><paxI:parasmEpaxI><XAwuH:vixaz><gaNaH:curAxiH><level:1>
nivexayan	vex1<upasarga:ni><prayogaH:karwari><lakAraH:laf><puruRaH:pra><vacanam:eka><paxI:parasmEpaxI><XAwuH:vexa><gaNaH:curAxiH><level:1>
nivexayanwi	vix1<upasarga:ni><prayogaH:karwari><lakAraH:lat><puruRaH:pra><vacanam:bahu><paxI:parasmEpaxI><XAwuH:vixL><gaNaH:BvAxiH><level:1>
nivexayawi	vix4<upasarga:ni><prayogaH:karwari><lakAraH:lat><puruRaH:pra><vacanam:eka><paxI:parasmEpaxI><XAwuH:vixa><gaNaH:curAxiH><level:1>
nivexayawu	vix1<upasarga:nir><sanAxi_prawyayaH:Nic><prayogaH:karwari><lakAraH:lot><puruRaH:pra><vacanam:eka><paxI:parasmEpaxI><XAwuH:vixL><gaNaH:svAxiH><level:1>
nivexayiRyAmi	vix1<upasarga:ni><prayogaH:karwari><lakAraH:lqt><puruRaH:u><vacanam:eka><paxI:parasEpaxI><XAwuH:IkRa><gaNaH:curAxiH><level:1>
nivexayiwum	vix1<upasarga:ni><vargaH:avy><sanAxi_prawyayaH:Nic><kqw_prawyayaH:wumun><XAwuH:vixaz><gaNaH:curAxiH><level:1>
nivexiwaH	vix1<upasarga:ni><kqw_prawyayaH:kwa><XAwuH:vixL><gaNaH:BvAxiH>nivexiwa<vargaH:nA><lifgam:puM><viBakwiH:1><vacanam:eka><level:1>
nixaXaw	nixaXaw<vargaH:nA><lifgam:napuM><viBakwiH:1><vacanam:eka><level:1>
niyojayasi	yuj1<upasarga:ni><sanAxi_prawyayaH:Nic><prayogaH:karwari><lakAraH:lat><puruRaH:ma><vacanam:eka><paxI:parasmEpaxI><XAwuH:yujaz><gaNaH:xivAxiH><level:1>/yuj2<upasarga:ni><sanAxi_prawyayaH:Nic><prayogaH:karwari><lakAraH:lat><puruRaH:ma><vacanam:eka><paxI:parasmEpaxI><XAwuH:yujIzr><gaNaH:ruXAxiH><level:1>/yuj3<upasarga:ni><prayogaH:karwari><lakAraH:lat><puruRaH:ma><vacanam:eka><paxI:parasmEpaxI><XAwuH:yujaz><gaNaH:curAxiH><level:1>
niyojiwaH	niyojiwa<vargaH:nA><lifgam:puM><viBakwiH:1><vacanam:eka><level:1>
niyokRyanwi	yuj1<upasarga:ni><prayogaH:karwari><lakAraH:lqt><puruRaH:pra><vacanam:eka><paxI:parasmEpaxI><XAwuH:yujaz><gaNaH:xivAxiH><level:1>
niyokRyawi	yuj2<upasarga:ni><prayogaH:karwari><lakAraH:lqt><puruRaH:pra><vacanam:eka><paxI:parasmEpaxI><XAwuH:yujizr><gaNaH:ruXAxiH><level:1>
nocew	nocew<vargaH:avy><level:1>
nqpANAm	nqpa<vargaH:nA><lifgam:puM><viBakwiH:6><vacanam:bahu><level:1>
nyapAwayaw	paw1<upasarga:ni><sanAxi_prawyayaH:Nic><prayogaH:karwari><lakAraH:laf><puruRaH:pra><vacanam:eka><paxI:parasmEpaxI><XAwuH:pawL><gaNaH:BvAxiH><level:1>
nyavArayaw	vq2<upasarga:ni><prayogaH:karwari><lakAraH:laf><puruRaH:pra><vacanam:eka><paxI:parasmEpaxI><XAwuH:vq><gaNaH:curAxiH><level:1>
nyavarwawa	vqw1<upasarga:ni><prayogaH:karwari><lakAraH:laf><puruRaH:pra><vacanam:eka><paxI:AwmanEpaxI><XAwuH:vqwu><gaNaH:BvAxiH><level:1>
nyavarwyaw	vruw1<upasarga:ni><prayogaH:karwari><lakAraH:laf><puruRaH:pra><vacanam:eka><paxI:parasmEpaxI><XAwuH:vruwu><gaNaH:curAxiH><level:1>
nyavexayan	vix1<upasarga:ni><prayogaH:karwari><lakAraH:laf><puruRaH:pra><vacanam:bahu><paxI:parasmEpaxI><XAwuH:vixa><gaNaH:BvAxiH><level:1>
nyavexayaw	vix1<upasarga:ni><prayogaH:karwari><lakAraH:laf><puruRaH:pra><vacanam:eka><paxI:parasmEpaxI><XAwuH:vixa><gaNaH:BvAxiH><level:1>
pATiwavAn	paT1<sanAxi_prawyayaH:Nic><kqw_prawyayaH:kwavawu><XAwuH:paTa><gaNaH:BvAxiH><kqw_pratipadika:pATiwavaw><vargaH:nA><lifgam:puM><viBakwiH:1><vacanam:eka><level:1>
pApAH	pApa<vargaH:nA><lifgam:puM><viBakwiH:1><vacanam:bahu><level:1>
pArafgawaH	pArafgawa<vargaH:nA><lifgam:puM><viBakwiH:1><vacanam:eka><level:1>
pAwayiwum	paw1<vargaH:avy><sanAxi_prawyayaH:Nic><kqw_prawyayaH:wumun><XAwuH:pawa><gaNaH:curAxiH><level:1>
pAyayiwvA	pA1<vargaH:avy><sanAxi_prawyayaH:Nic><kqw_prawyayaH:kwvA><XAwuH:pA><gaNaH:BvAxiH><level:1>
pIwam	pIwa<vargaH:nA><lifgam:napuM><viBakwiH:1><vacanam:eka><level:1>
paFcarAw	paFcara<vargaH:nA><lifgam:puM><viBakwiH:5><vacanam:eka><level:1>
palAyiwavAn	pal<sanAxi_prawyayaH:Nic><kqw_prawyayaH:kwavawu><XAwuH:pala><gaNaH:BvAxiH><kqw_pratipadika:palAyiwavaw><vargaH:nA><lifgam:puM><viBakwiH:1><vacanam:eka><level:1>
parAvarwamAnam	parAvarwamAna<vargaH:nA><lifgam:puM><viBakwiH:2><vacanam:eka><level:1>
parAvarwasva	vqw1<upasarga:para_Af><prayogaH:karwari><lakAraH:lot><puruRaH:pra><vacanam:eka><paxI:AwmanepaxI><XAwuH:vqwu><gaNaH:BvAxiH><level:1>
parAvarwayaw	vqw1<upasarga:para_Af><prayogaH:karwari><lakAraH:lof><puruRaH:pra><vacanam:eka><paxI:AwmanepaxI><XAwuH:vqwu><gaNaH:BvAxiH><level:1>
parAvarwsyawi	vqw1<upasarga:para_Af><prayogaH:karwari><lakAraH:lqt><puruRaH:pra><vacanam:eka><paxI:parasmEpaxI><XAwuH:vqwu><gaNaH:BvAxiH><level:1>/vqwu1<upasarga:para_Af><prayogaH:karwari><lakAraH:lqt><puruRaH:pra><vacanam:eka><paxI:parasmEpaxI><XAwuH:vqwu><gaNaH:BvAxiH><level:1>
parIkRanwe	IkRa1<upasarga:pari><prayogaH:karwari><lakAraH:lat><puruRaH:pra><vacanam:bahu><paxI:AwmanepaxI><XAwuH:IkRa><gaNaH:BvAxiH><level:1>
parIkRawe	IkR1<upasarga:pari><prayogaH:karwari><lakAraH:lat><puruRaH:pra><vacanam:eka><paxI:AwmanepaxI><XAwuH:IkRa><gaNaH:BvAxiH><level:1>
parameSvara	parameSvara<vargaH:nA><lifgam:puM><viBakwiH:8><vacanam:eka><level:1>
pariRvajamAnaH	pariRvajamAna<vargaH:nA><lifgam:puM><viBakwiH:1><vacanam:eka><level:1>
pariRvajmAnaH	pariRvajmAna<vargaH:nA><lifgam:puM><viBakwiH:1><vacanam:eka><level:1>
paricAyayan	paricAyayaw<vargaH:nA><lifgam:puM><viBakwiH:1><vacanam:eka><level:1>
paricakRawe	cakR1<upasarga:pari><prayogaH:karwari><lakAraH:lat><puruRaH:pra><vacanam:bahu><paxI:AwmanepaxI><XAwuH:cakRizf><gaNaH:axAxiH><level:1>
parisamApyawe	Ap1<upasarga:pari_sam><prayogaH:karmaNi><lakAraH:lat><puruRaH:pra><vacanam:eka><paxI:AwmanepaxI><XAwuH:ApLz><gaNaH:svAxiH><level:1>
parivarwiwaH	vqw1<upasarga:pari><kqw_prawyayaH:kwa><XAwuH:vqwuz><gaNaH:BvAxiH><kqw_pratipadika:parivarwiwa><vargaH:nA><lifgam:puM><viBakwiH:1><vacanam:eka><level:1>
parivarwiwam	parivarwiwa<vargaH:nA><lifgam:napuM><viBakwiH:1><vacanam:eka><level:1>
parivarwiwaveSO	parivarwiwaveSa<vargaH:nA><lifgam:puM><viBakwiH:1><vacanam:xvi><level:1>
pariveRayAni	viR1<upasarga:pari><sanAxi_prawyayaH:Nic><prayogaH:karwari><lakAraH:lot><puruRaH:u><vacanam:eka><paxI:parasmEpaxI><XAwuH:viRaz><gaNaH:BvAxiH><level:1>
parixahyawe	xah1<upasarga:pari><prayogaH:karmaNi><lakAraH:lat><puruRaH:pra><vacanam:eka><paxI:AwmanepaxI><XAwuH:xahaz><gaNaH:BvAxiH><level:1>
parpatam	parpata<vargaH:nA><lifgam:puM><viBakwiH:2><vacanam:eka><level:1>
paryacayayaw	ci1<upasarga:pari><sanAxi_prawyayaH:Nic><prayogaH:karwari><lakAraH:laf><puruRaH:pra><vacanam:eka><paxI:parasmEpaxI><XAwuH:ci><gaNaH:curAxiH><level:1>
paryatan	at1<upasarga:pari><kqw_prawyayaH:Sawq><XAwuH:ataz><gaNaH:BvAxiH><kqw_pratipadika:paryataw><vargaH:nA><lifgam:napuM><viBakwiH:1><vacanam:1>
paryavawiRTawe	RWA1<upasarga:pari_ava><prayogaH:karwari><lakAraH:lat><puruRaH:pra><vacanam:eka><paxI:AwmanepaxI><XAwuH:RWA><gaNaH:BvAxiH><level:1>
paryaveRayaw	viR1<upasarga:pari><sanAxi_prawyayaH:Nic><prayogaH:karwari><lakAraH:laf><puruRaH:pra><vacanam:eka><paxI:parasmEpaxI><XAwuH:viRaz><gaNaH:BvAxiH><level:1>
pipaTiRuH	pipaTiRu<vargaH:nA><lifgam:puM><viBakwiH:1><vacanam:eka><level:1>
pqRTawaH	pqRTa<vargaH:avy><waxXiwa_prawyayaH:wasil><level:1>
prAboXayaw	buX1<upasarga:pra><prayogaH:karwari><lakAraH:laf><puruRaH:pra><vacanam:eka><paxI:parasmEpaxI><XAwuH:buXir><gaNaH:curAxiH><level:1>
prAha	brU1<upasarga:pra><prayogaH:karwari><lakAraH:lat><puruRaH:pra><vacanam:eka><paxI:parasmEpaxI><XAwuH:brUF><gaNaH:axAxiH><level:1>
prAhuH	brU1<upasarga:pra><prayogaH:karwari><lakAraH:lat><puruRaH:pra><vacanam:bahu><paxI:parasmEpaxI><XAwuH:brUF><gaNaH:axAxiH><level:1>
prAkASayaw	kaSa1<upasarga:pra_Af><prayogaH:karwari><lakAraH:laf><puruRaH:pra><vacanam:eka><paxI:parasmEpaxI><XAwuH:kaSa><gaNaH:BvAxiH><level:1>
prApayan	prApayaw<vargaH:nA><lifgam:puM><viBakwiH:1><vacanam:eka><level:1>
prApwavAn	Ap1<upasarga:pra><kqw_prawyayaH:kwavawu><XAwuH:ApLz><gaNaH:svAxiH><kqw_pratipadika:prApwavaw><vargaH:nA><lifgam:puM><viBakwiH:1><vacanam:eka><level:1>
prApwavanwO	Ap1<upasarga:pra><kqw_prawyayaH:kwavawu><XAwuH:ApLz><gaNaH:sAxiH><kqw_pratipadika:prApwavaw><vargaH:nA><lifgam:puM><viBakwiH:1><vacanam:xvi><level:1>/Ap1<upasarga:pra><kqw_prawyayaH:kwavawu><XAwuH:ApLz><gaNaH:sAxiH><kqw_pratipadika:prApwavaw><vargaH:nA><lifgam:puM><viBakwiH:2><vacanam:xvi><level:1>
prArWiwavAn	prArWiwavaw<vargaH:nA><lifgam:puM><viBakwiH:1><vacanam:eka><level:1>
prAraBawa	raB1<upasarga:pra_Af><prayogaH:karwari><lakAraH:laf><puruRaH:pra><vacanam:eka><paxI:AwmanepaxI><XAwuH:raBa><gaNaH:BvAxiH><level:1>
prAraBawe	raB1<upasarga:pra_Af><prayogaH:karwari><lakAraH:lat><puruRaH:pra><vacanam:eka><paxI:AwmanepaxI><XAwuH:raBaz><gaNaH:BvAxiH><level:1>
prAramBamANaH	prAramBamANa<vargaH:nA><lifgam:puM><viBakwiH:1><vacanam:eka><level:1>
prAyacCaw	xA1<upasarga:pra><prayogaH:karwari><lakAraH:laf><puruRaH:pra><vacanam:eka><paxI:parasmEpaxI><XAwuH:xANc><gaNaH:BvAxiH><level:1>
prERayaw	iR1<upasarga:pra><sanAxi_prawyayaH:Nic><prayogaH:karwari><lakAraH:laf><puruRaH:pra><vacanam:eka><paxI:AwmanepaxI><XAwuH:iR11><gaNaH:BvAxiH><level:1>
prERiwavAn	IR1<upasarga:pra><kqw_prawyayaH:kwavawu><XAwuH:IRaz><gaNaH:BvAxiH><kqw_pratipadika:prERiwavaw><vargaH:nA><lifgam:puM><viBakwiH:1><vacanam:eka><level:1>
praBAviwaH	praBAviwa<vargaH:nA><lifgam:puM><viBakwiH:1><vacanam:eka><level:1>
praBqwayAH	praBqwi<vargaH:nA><lifgam:swrI><viBakwiH:3><vacanam:bahu><level:1>
praNipawanwIm	pranipawaw<vargaH:nA><lifgam:swrI><viBakwiH:2><vacaam:1><level:1>
praSaMsan	praSaMsaw<vargaH:nA><lifgam:puM><viBakwiH:1><vacanam:eka><level:1>
praXAviwavAn	XAv1<upasarga:pra><kqw_prawyayaH:kwavawu><XAwuH:XAvuz><gaNaH:BvAxiH><kqw_pratipadika:praXAviwavaw><vargaH:nA><lifgam:puM><viBakwiH:1><vacanam:eka><level:1>
pracArayAmAsa	car1<upasarga:pra><sanAxi_prawyayaH:Nic><prayogaH:karwari><lakAraH:lit><puruRaH:pra><vacanam:eka><paxI:parasmEpaxI><XAwuH:cara><gaNaH:BvAxiH><level:1>
pracArayiRyAmaH	car2<upasarga:pra><prayogaH:karwari><lakAraH:lqt><puruRaH:u><vacanam:bahu><paxI:parasmEpaxI><XAwuH:cara><gaNaH:curAxiH><level:1>
prahAreNa	prahAra<vargaH:nA><lifgam:puM><viBakwiH:3><vacanam:eka><level:1>
praharaNAH	hq1<upasarga:pra><kqw_prawyayaH:lyut><XAwuH:hq><gaNaH:BvAxiH><kqw_pratipadika:haraNa><vargaH:nA><lifgam:puM><viBakwiH:1><vacanam:bahu><level:1>
prajAnAmi	jFA1<upasarga:pra><prayogaH:karwari><lakAraH:lat><puruRaH:u><vacanam:eka><paxI:parasmEpaxI><XAwuH:jFA><gaNaH:kryAxiH><level:1>
prajvAlayiwum	jval1<upasarga:pra><vargaH:avy><sanAxi_prawyayaH:Nic><kqw_prawyayaH:wumun><XAwuH:jvala><gaNaH:BvAxiH><level:1>
prajvAlya	jval1<upasarga:pra><vargaH:avy><sanAxi_prawyayaH:Nic><kqw_prawyayaH:lyap><XAwuH:jvala><gaNaH:curAxiH><level:1>
prakASayawi	kAS1<upasarga:pra><sanAxi_prawyayaH:Nic><prayogaH:karwari><lakAraH:lat><puruRaH:pra><vacanam:eka><paxI:parasmEpaxI><XAwuH:kASqz><gaNaH:BvAxiH><level:1>
prakRAlayAmaH	kRal1<upasarga:pra><prayogaH:karwari><lakAraH:lat><puruRaH:u><vacanam:bahu><paxI:parasmEpaxI><XAwuH:kRalaz><gaNaH:curAxiH><level:1>
prakRAlayAmi	kRal1<upasarga:pra><prayogaH:karwari><lakAraH:lat><puruRaH:u><vacanam:eka><paxI:parasmEpaxI><XAwuH:kRalaz><gaNaH:curAxiH><level:1>
prakRAlayaWa	kRal1<upasarga:pra><prayogaH:karwari><lakAraH:lat><puruRaH:ma><vacanam:eka><paxI:parasmEpaxI><XAwuH:kRala><gaNaH:curAxiH><level:1>
prakRAlayasi	kRal1<upasarga:pra><prayogaH:karwari><lakAraH:lat><puruRaH:ma><vacanam:eka><paxI:parasmEpaxI><XAwuH:kRalaz><gaNaH:curAxiH><level:1>
prakRAlayawi	kRal1<upasarga:pra><prayogaH:karwari><lakAraH:lat><puruRaH:pra><vacanam:eka><paxI:parasmEpaxI><XAwuH:kRalaz><gaNaH:curAxiH><level:1>
prakRAlayew	kRal1<upasarga:pra><prayogaH:karwari><lakAraH:viXilif><puruRaH:pra><vacanam:eka><paxI:parasmEpaxI><XAwuH:kRala><gaNaH:curAxiH><level:1>
prakRAlayiwum	kRal1<vargaH:avy><upasarga:pra><sanAxi_prawyayaH:Nic><kqw_prawyayaH:wumun><XAwuH:kRalaz><gaNaH:curAxiH><level:1>
prakatayanwi	kat1<upasarga:pra><sanAxi_prawyayaH:Nic><prayogaH:karwari><lakAraH:lat><puruRaH:pra><vacanam:bahu><paxI:parasmEpaxI><XAwuH:kate><gaNaH:BvAxiH><level:1>
prakatayawi	kat1<upasarga:pra><sanAxi_prawyayaH:Nic><prayogaH:karwari><lakAraH:lat><puruRaH:pra><vacanam:eka><paxI:parasmEpaxI><XAwuH:kate><gaNaH:BvAdiH><level:1>
prakatiwavanwO	prakatiwavaw<vargaH:nA><lifgam:puM><viBakwiH:1><vacanam:xvi><level:1>
prakatiwavanwaH	prakatiwavaw<vargaH:nA><lifgam:puM><viBakwiH:1><vacanam:bahu><level:1>
prakatiwavawI	kat1<upasarga:pra><kqw_prawyayaH:kwavawu><XAwuH:kata><gaNaH:BvAxiH><kqw_pratipadika:prakatiwavawI><vargaH:nA><lifgam:swrI><viBakwiH:1><vacanam:eka>
pramAWIni	pramAWin<vargaH:nA><lifgam:napuM><viBakwiH:1><vacanam:bahu><level:1>
pramawwaH	max1<upasarga:pra><kqw_prawyayaH:kwa><XAwuH:maxiz><gaNaH:BvAxiH>pramawwa<vargaH:nA><lifgam:puM><viBakwiH:1><vacanam:eka><level:2>
pramucyawe	muc1<upasarga:pra><prayogaH:karmaNi><lakAraH:lat><puruRaH:pra><vacanam:eka><paxI:AwmanepaxI><XAwuH:mucLz><gaNaH:wuxAxiH><level:1>
pramumoxa	mux1<upasarga:pra><prayogaH:karwari><lakAraH:lit><puruRaH:pra><vacanam:eka><paxI:parasmEpaxI><XAwuH:muxaz><gaNaH:BvAxiH><level:1>
prapawiwaH	paw1<upasarga:pra><kqw_prawyayaH:kwa><XAwuH:pawLz><gaNaH:BvAxiH><kqw_pratipadika:prapawiwa><vargaH:nA><lifgam:puM><viBakwiH:1><vacanam:eka><level:1>
prasArayAmi	sq1<upasarga:pra><sanAxi_prawyayaH:Nic><prayogaH:karwari><lakAraH:lat><puruRaH:u><vacanam:bahu><paxI:parasmEpaxI><XAwuH:sq><gaNaH:BvAxiH><level:1>
prasAriwavAn	sq1<upasarga:pra><sanAxi_prawyayaH:Nic><kqw_prawyayaH:kwavawu><XAwuH:sq><gaNaH:BvAxiH><kqw_pratipadika:prasAriwavaw><vargaH:nA><lifgam:puM><viBakwiH:1><vacanam:eka><level:1>
prasArya	sq1<upasarga:pra><vargaH:avy><sanAxi_prawyayaH:Nic><kqw_prawyayaH:lyap><XAwuH:sq><gaNaH:BvAxiH><level:1>
prasAxaye	Rax1<upasarga:pra><sanAxi_prawyayaH:Nic><prayogaH:karwari><lakAraH:lat><puruRaH:u><vacanam:eka><paxI:AwmanepaxI><XAwuH:RaxLz><gaNaH:BvAxiH><level:1>
prasUwA	prasUwA<vargaH:nA><lifgam:swrI><viBakwiH:1><vacanam:eka><level:1>
prasWApayAmAsa	RWA1<upasarga:pra><sanAxi_prawyayaH:Nic><prayogaH:karwari><lakAraH:lit><puruRaH:pra><vacanam:eka><paxI:parasmEpaxI><XAwuH:RWA><gaNaH:BvAxiH><level:1>
prasWiwaH	RWA1<vargaH:nA><kqw_prawyayaH:kwa><XAwuH:RWA><gaNaH:BvAxiH><lifgam:puM><viBakwiH:1><vacanam:eka><level:1>
prasWiwavAn	RWA1<upasarga:pra><kqw_prawyayaH:kwavawu><XAwuH:RWA><gaNaH:BvAxiH><kqw_pratipadika:prasWiwavaw><vargaH:nA><lifgam:puM><viBakwiH:1><vacanam:eka><level:1>
prasaranwaH	sq1<upasarga:pra><kqw_prawyayaH:Sawq_lat><XAwuH:sq><gaNaH:BvAxiH>prasaraw<vargaH:nA><lifgam:puM><viBakwiH:1><vacanam:bahu><level:1>/sq1<upasarga:pra><kqw_prawyayaH:Sawq_lat><XAwuH:sq><gaNaH:BvAxiH>prasaraw<vargaH:nA><lifgam:puM><viBakwiH:1><vacanam:bahu><level:1>
prasaviRyaXvam	sU2<upasarga:pra><prayogaH:karwari><lakAraH:lqt><puruRaH:ma><vacanam:bahu><paxI:AwmanepaxI><XAwuH:RUf><gaNaH:xivAxiH><level:1>
prasixXyew	siX3<upasarga:pra><prayogaH:karwari><lakAraH:viXilif><puruRaH:pra><vacanam:eka><paxI:parasmEpaxI><XAwuH:RiXuz><gaNaH:xivAxiH><level:1>
pravAhayan	pravAhayaw<vargaH:nA><lifgam:puM><viBakwiH:1><vacanam:eka><level:1>
praveSayiRyAmi	viS1<upasarga:pra><sanAxi_prawyayaH:Nic><prayogaH:karwari><lakAraH:lqt><puruRaH:u><vacanam:eka><paxI:parasmEpaxI><XAwuH:viSaz><gaNaH:wuxAxiH><level:1>
pravilIyawe	lI1<upasarga:pra_vi><prayogaH:karwari><lakAraH:lat><puruRaH:pra><vacanam:eka><paxI:AwmanepaxI><XAwuH:lIf><gaNaH:xivAxiH><level:1>
pravqwwavAn	Ap1<upasarga:pra><kqw_prawyayaH:kwavawu><XAwuH:ApLz><gaNaH:BvAxiH><kqw_pratipadika:pravqwwavaw><vargaH:nA><lifgam:puM><viBakwiH:1><vacanam:eka><level:1>
pravyaWiwAH	vyaW1<upasarga:pra><kqw_prawyayaH:kwa><XAwuH:vyaWaz><gaNaH:BvAxiH><kqw_pratipadika:pravyaWiwa><vargaH:nA><lifgam:puM><viBakwiH:1><vacanam:bahu><level:1>
pravyaWiwaH	vyaW1<upasarga:pra><kqw_prawyayaH:kwa><XAwuH:vyaWaz><gaNaH:BvAxiH><kqw_pratipadika:pravyaWiwa><vargaH:nA><lifgam:puM><viBakwiH:1><vacanam:eka><level:1>
pravyaWiwam	pravyaWiwa<vargaH:nA><lifgam:napuM><viBakwiH:1><vacanam:eka><level:1>/pravyaWiwa<vargaH:nA><lifgam:napuM><viBakwiH:2><vacanam:eka><level:1>/pravyaWiwa<vargaH:nA><lifgam:puM><viBakwiH:2><vacanam:eka><level:1>
prawIyamAnaH	prawIyamAna<vargaH:nA><lifgam:puM><viBakwiH:1><vacanam:eka><level:1>
prawapanwi	wap1<upasarga:pra><prayogaH:karwari><lakAraH:lat><puruRaH:pra><vacanam:eka><paxI:parasmEpaxI><XAwuH:wapaz><gaNaH:BvAxiH><level:1>
prawiBUm	prawiBU<vargaH:nA><lifgam:puM><viBakwiH:2><vacanam:eka><level:1>
prawiRTApya	RWA1<upasarga:prawi><vargaH:avy><sanAxi_prawyayaH:Nic><kqw_prawyayaH:lyap><XAwuH:RWA><gaNaH:BvAxiH><level:1>
prawijAnIhi	jFA1<upasarga:prawi><prayogaH:karwari><lakAraH:lot><puruRaH:ma><vacanam:eka><paxI:parasmEpaxI><XAwuH:jFA><gaNaH:kryAxiH><level:1>
prawijAne	jFA1<upasarga:prawi><prayogaH:karwari><lakAraH:lat><puruRaH:u><vacanam:eka><paxI:AwmanepaxI><XAwuH:jFA><gaNaH:kryAxiH><level:1>
prawijFAwaH	jFA1<upasarga:prawi><kqw_prawyayaH:kwa><XAwuH:jFA><gaNaH:krayAxiH><kqw_pratipadika:prawijFAwa><vargaH:nA><lifgam:puM><viBakwiH:1><vacanam:eka><level:1>
prawipAxaya	pax1<upasarga:prawi><prayogaH:karwari><lakAraH:lot><puruRaH:ma><vacanam:eka><paxI:parasmEpaxI><XAwuH:pax><gaNaH:curAxiH><level:1>
prawiyowsyAmi	yuX1<upasarga:prawi><prayogaH:karwari><lakAraH:lqt><puruRaH:u><vacanam:eka><paxI:parasmEpaxI><XAwuH:yuXaz><gaNaH:xivAxiH><level:1>
prawiyowsyAmi	yuX1<upasarga:prawi><sanAxi_prawyayaH:X><prayogaH:karwari><lakAraH:lqt><puruRaH:u><vacanam:eka><paxI:parasmEpaxI><XAwuH:yuXaz><gaNaH:xivAxiH><level:1>
prawyAvarwayawa	vqwu1<upasarga:prawi_Af><sanAxi_prawyayaH:Nic><prayogaH:karwari><lakAraH:laf><puruRaH:pra><vacanam:eka><paxI:AwmanepaxI><XAwuH:vqwu><gaNaH:BvAxiH><level:1>
prawyanayaw	NI1<upasarga:prawi><prayogaH:karwari><lakAraH:laf><puruRaH:pra><vacanam:eka><paxI:AwmanepaxI><XAwuH:NI><gaNaH:BvAxiH><level:1>
prawyapAxayaw	pax1<upasarga:prawi><sanAxi_prawyayaH:Nic><prayogaH:karwari><lakAraH:laf><puruRaH:pra><vacanam:eka><paxI:parasmEpaxI><XAwuH:paxaz><gaNaH:xivAxiH><level:1>
praxaXmawuH	XmA1<upasarga:pra><prayogaH:karwari><lakAraH:lit><puruRaH:pra><vacanam:xvi><paxI:parasmEpaxI><XAwuH:XmA><gaNaH:BvAxiH><level:1>
prayacCa	xA1<upasarga:pra><prayogaH:karwari><lakAraH:lot><puruRaH:ma><vacanam:eka><paxI:parasmEpaxI><XAwuH:xAN><gaNaH:BvAxiH><level:1>
prayacCanwi	xA<upasarga:pra><prayogaH:karwari><lakAraH:lat><puruRaH:pra><vacanam:bahu><paxI:parasmEpaxI><XAwuH:xAN><gaNaH:BvAxiH><level:1>
prayacCawi	yam2<upasarga:pra><prayogaH:karwari><lakAraH:lat><puruRaH:pra><vacanam:eka><paxI:parasmEpaxI><XAwuH:yamaz><gaNaH:BvAxiH><level:1>
prayuyuje	yuj2<upasarga:pra><prayogaH:karwari><lakAraH:lit><puruRaH:pra><vacanam:eka><paxI:AwmanepaxI><XAwuH:yujizr><gaNaH:ruXAxiH><level:1>
procyawe	brU1<upasarga:pra><prayogaH:karmaNi><lakAraH:lat><puruRaH:pra><vacanam:eka><paxI:AwmanepaxI><XAwuH:brUF><gaNaH:axAxiH><level:1>
prokwA	vac1<upasarga:pra><kqw_prawyayaH:kwa><XAwuH:vacaz><gaNaH:axAxiH><kqw_pratipadika:prokwA><lifgam:swrI><viBakwiH:1><vacanam:eka><level:2>
prokwAni	vac1<upasarga:pra><kqw_prawyayaH:kwa><XAwuH:vacaz><gaNaH:axAxiH><kqw_pratipadika:prokwa><lifgam:napuM><viBakwiH:1><vacanam:bahu><level:2>/vac1<upasarga:pra><kqw_prawyayaH:kwa><XAwuH:vacaz><gaNaH:axAxiH><kqw_pratipadika:prokwa><lifgam:napuM><viBakwiH:2><vacanam:bahu><level:2>
prokwaH	vac1<upasarga:pra><kqw_prawyayaH:kwa><XAwuH:vacaz><gaNaH:axAxiH><kqw_pratipadika:prokwa><lifgam:puM><viBakwiH:1><vacanam:eka><level:2>
prokwam	vac1<upasarga:pra><kqw_prawyayaH:kwa><XAwuH:vacaz><gaNaH:axAxiH><kqw_pratipadika:prokwa><lifgam:napuM><viBakwiH:1><vacanam:eka><level:2>/vac1<upasarga:pra><kqw_prawyayaH:kwa><XAwuH:vacaz><gaNaH:axAxiH><kqw_pratipadika:prokwa><lifgam:napuM><viBakwiH:2><vacanam:eka><level:2>/vac1<upasarga:pra><kqw_prawyayaH:kwa><XAwuH:vacaz><gaNaH:axAxiH><kqw_pratipadika:prokwa><lifgam:puM><viBakwiH:2><vacanam:eka><level:2>
prokwavAn	vac1<upasarga:pra><kqw_prawyayaH:kwavawu><XAwuH:vacaz><gaNaH:axAxiH>prokwavaw<vargaH:nA><lifgam:puM><viBakwiH:2><vacanam:eka><level:2>
prowsAhayaw	Rah1<upasarga:pra_uw><prayogaH:karwari><lakAraH:laf><puruRaH:pra><vacanam:eka><paxI:parasmEpaxI><XAwuH:sah><gaNaH:xivAxiH><level:1>
puRpakam	puRpaka<vargaH:nA><lifgam:puM><viBakwiH:2><vacanam:eka><level:1>
puRpakeNa	puRpaka<vargaH:nA><lifgam:puM><viBakwiH:3><vacanam:eka><level:1>
pumAn	puzs<vargaH:nA><lifgam:puM><viBakwiH:1><vacanam:eka><level:1>
puruRarRaBa	puruRarRaBa<vargaH:nA><lifgam:puM><viBakwiH:8><vacanam:eka><level:1>
puruRavyAGra	puruRavyAGra<vargaH:nA><lifgam:puM><viBakwiH:8><vacanam:eka><level:1>
qRyaSrqfgasya	qRyaSrqfga<vargaH:nA><lifgam:puM><viBakwiH:6><vacanam:eka><level:1>
rAhulaH	rAhula<vargaH:nA><lifgam:puM><viBakwiH:1><vacanam:eka><level:1>
rAhulasya	rAhula<vargaH:nA><lifgam:puM><viBakwiH:6><vacanam:eka><level:1>
rAjyasuKaloBena	rAjyasuKaloBa<vargaH:nA><lifgam:puM><viBakwiH:3><vacanam:eka><level:1>
rAmacariwam	rAmacariwa<vargaH:nA><lifgam:napuM><viBakwiH:2><vacanam:eka><level:1>
rAmakqRNaH	rAmakqRNa<vargaH:nA><lifgam:puM><viBakwiH:1><vacanam:eka><level:1>
raFjiwa	raFjiwa<vargaH:nA><lifgam:puM><viBakwiH:8><vacanam:eka><level:1>
ramaNIyawAyAH	ramaNIyawA<vargaH:nA><lifgam:swrI><viBakwiH:6><vacanam:eka><level:1>/ramaNIyawA<vargaH:nA><lifgam:swrI><viBakwiH:7><vacanam:eka><level:1>
ramanwi	ram1<prayogaH:karwari><lakAraH:lat><puruRaH:pra><vacanam:bahu><paxI:parasmEpaxI><gaNaH:BvAxiH><level:1>
rameSa	rameSa<vargaH:nA><lifgam:puM><viBakwiH:8><vacanam:eka><level:1>
sAMKyam	sAfKya<vargaH:nA><lifgam:puM><viBakwiH:2><vacanam:eka><level:1>
sAXayew	Rix1<sanAxi_prawyayaH:Nic><prayogaH:karwari><lakAraH:viXilif><puruRaH:pra><vacanam:eka><paxI:parasmEpaxI><XAwuH:Rix><gaNaH:BvAxiH><level:1>
sAXayiwum	sAX1<vargaH:avy><sanAxi_prawyayaH:Nic><kqw_prawyayaH:wumun><XAwuH:sAXa><gaNaH:xivAxiH>
sAkRAwkurvanwaH	sAkRAwkurvaw<vargaH:nA><lifgam:puM><viBakwiH:1><vacanam:bahu><level:1>
sAkRiNI	sAkRiNI<vargaH:nA><lifgam:swrI><viBakwiH:1><vacanam:eka><level:1>
sAxaram	sAxara<vargaH:nA><lifgam:napuM><viBakwiH:2><vacanam:eka><level:1>
sOkRmyAw	sOkRmya<vargaH:nA><linfgam:napuM><viBakwiH:1><vacanam:eka><level:1>
sUryaSarmA	sUryaSarman<vargaH:nA><lifgam:puM><viBakwiH:1><vacanam:eka><level:1>
sWApayiwum	RWA1<vargaH:avy><sanAxi_prawyayaH:Nic><kqw_prawyayaH:wumun><XAwuH:RWA><gaNaH:BvAxiH><level:1>
sWApayiwvA	RWA1<vargaH:avy><sanAxi_prawyayaH:Nic><kqw_prawyayaH:kwvA><XAwuH:RWA><gaNaH:BvAxiH><level:1>
sWagayiwvA	RWA1<vargaH:avy><sanAxi_prawyayaH:Nic><kqw_prawyayaH:kwvA><XAwuH:RWA><gaNaH:BvAxiH><level:1>
saFjAnIwe	jFA2<upasarga:sam><prayogaH:karwari><lakAraH:lat><puruRaH:pra><vacanam:eka><paxI:AwmanepaxI><XAwuH:jFA><gaNaH:kryAxiH><level:1>
saFjAwAH	jan1<upasarga:sam><kqw_prawyayaH:kwa><XAwuH:janIz><gaNaH:xivAxiH><kqw_pratipadika:saFjAwa><vargaH:nA><lifgam:puM><viBakwiH:1><vacanam:bahu><level:1>
saFjAyawe	jan3<upasarga:sam><prayogaH:karwari><lakAraH:lat><puruRaH:pra><vacanam:eka><paxI:AwmanepaxI><XAwuH:janIz><gaNaH:xivAxiH><level:1>
saFjFake	saFjFaka<vargaH:nA><lifgam:puM><viBakwiH:7><vacanam:eka><level:1>
saFjanayan	jan2<upasarga:sam><kqw_prawyayaH:Sawq_lat><XAwuH:janI><gaNaH:xivAxiH>saFjanayaw<vargaH:nA><lifgam:puM><viBakwiH:1><vacanam:eka><level:1>
saMSoBawe	SuB1<upasarga:sam><prayogaH:karwari><lakAraH:lat><puruRaH:pra><vacanam:eka><paxI:AwmanepaxI><XAwuH:SuBa><gaNaH:BvAxiH><level:1>
saMgacCawe	gam1<upasarga:sam><prayogaH:karwari><lakAraH:lat><puruRaH:pra><vacanam:eka><paxI:AwmanepaxI><XAwuH:gamL><gaNaH:BvAxiH><level:1>
saMjFEH	saFjFa<vargaH:nA><lifgam:puM><viBakwiH:3><vacanam:bahu><level:1>
saMnyAsinaH	saMnyAsin<vargaH:nA><lifgam:puM><viBakwiH:6><vacanam:eka><level:1>
saMsWApya	RWA1<upasarga:sam><vargaH:avy><kqw_prawyayaH:lyap><XAwuH:RWA><gaNaH:BvAxiH><level:1>
saMsixXim	saMsixXi<kqw_XAwu:RiX><upasarga:sam><kqw_prawyayaH:kwin><XAwuH:RiX><gaNaH:xivAxiH>sixXi<vargaH:nA><lifgam:swrI><viBakwiH:2><vacanam:eka><level:1>
saMswaBya	RwaB1<upasarga:sam><vargaH:avy><kqw_prawyayaH:lyap><XAwuH:RwaBiz><gaNaH:BvAxiH><level:1>
saMvAhyamAnam	saMvAhyamAn<vargaH:nA><lifgam:puM><viBakwiH:1><vacanam:xvi><level:1>
saMvarXiwaH	vqXuz<upasarga:sam><kqw_prawyayaH:kwa><XAwuH:vqXuz><gaNaH:BvAxiH><kqw_pratipadika:saMvarXiwa><vargaH:nA><lifgam:puM><viBakwiH:1><vacanam:eka><level:1>
saMvarxXiwA	vqX1<upasarga:sam><prayogaH:karwari><lakAraH:lut><puruRaH:pra><vacanam:eka><paxI:parasmEpaxI><XAwuH:vqXu><gaNaH:BvAxiH><leve:0>
saMyacCawe	yam1<upasarga:sam><prayogaH:karwari><lakAraH:lat><puruRaH:pra><vacanam:eka><paxI:AwmanepaxI><XAwuH:xAN><gaNaH:BvAxiH><level:1>
saMyamawAm	samyamaw<vargaH:nA><lifgam:puM><viBakwiH:6><vacanam:bahu><level:1>
saMyojayAmi	yuj1<upasarga:sam><sanAxi_prawyayaH:Nic><prayogaH:karwari><lakAraH:lat><puruRaH:uwa><vacanam:eka><paxI:parasmEpaxI><XAwuH:yujir><gaNaH:ruXAxiH><level:1>
saMyojayawi	yuj3<upasarga:sam><prayogaH:karwari><lakAraH:lat><puruRaH:pra><vacanam:eka><paxI:parasmEpaxI><XAwuH:yuj><gaNaH:curAxiH><level:1>
sacarAcaram	sacarAcara<vargaH:nA><lifgam:puM><viBakwiH:2><vacanam:eka><level:1>
safGAH	sanfGa<vargaH:nA><lifgam:puM><viBakwiH:1><vacanam:bahu><level:1>
safkRepawaH	safkRepa<vargaH:avy><waxXiwa_prawyayaH:wasil><level:1>
safkruXyasi	kruX1<upasarga:sam><prayogaH:karwari><lakAraH:lat><puruRaH:ma><vacanam:eka><paxI:parasmEpaxI><XAwuH:kruXa><gaNaH:xivAxiH><level:1>
sajjanwe	Rasj1<prayogaH:karwari><lakAraH:lat><puruRaH:pra><vacanam:bahu><paxI:AwmanepaxI><gaNaH:BvAxiH><level:1>
sajjawe	Rasj1<prayogaH:karwari><lakAraH:lat><puruRaH:pra><vacanam:eka><paxI:AwmanepaxI><gaNaH:BvAxiH><level:1>
samASvAsya	Svas1<upasarga:sam_Af><vargaH:avy><sanAxi_prawyayaH:Nic><kqw_prawyayaH:lyap><XAwuH:Svasaz><gaNaH:axAxiH><level:1>
samAcara	car1<upasarga:sam_Af><prayogaH:karwari><lakAraH:lot><puruRaH:ma><vacanam:eka><paxI:parasmEpaxI><XAwuH:caraz><gaNaH:BvAxiH><level:1>
samAcaran	samAcaraw<vargaH:nA><lifgam:puM><viBakwiH:1><vacanam:eka><level:1>
samAcarawi	cq<upasarga:sam_Af><prayogaH:karwari><lakAraH:lat><puruRaH:pra><vacanam:eka><paxI:parasmEpaxI><XAwuH:cq><gaNaH:curAxiH><level:1>
samAcarew	car1<upasarga:sam_Af><prayogaH:karwari><lakAraH:viXilif><puruRaH:pra><vacanam:eka><paxI:parasmEpaxI><XAwuH:caraz><gaNaH:BvAxiH><level:1>
samAgacCaw	gam1<upasarga:sam_Af><prayogaH:karwari><lakAraH:laf><puruRaH:pra><vacanam:eka><paxI:parasmEpaxI><XAwuH:gamL><gaNaH:BvAxiH><level:1>
samAgamanam	gam1<upasarga:sam_Af><kqw_prawyayaH:lyut><XAwuH:gamLz><gaNaH:BvAxiH><kqw_pratipadika:samAgamana><vargaH:nA><lifgam:napuM><viBakwiH:2><vacanam:eka><level:1>/gam1<upasarga:sam_Af><kqw_prawyayaH:lyut><XAwuH:gamLz><gaNaH:BvAxiH><kqw_pratipadika:samAgamana><vargaH:nA><lifgam:napuM><viBakwiH:1><vacanam:eka><level:1>
samAgawya	gam1<upasarga:sam_Af><vargaH:avy><kqw_prawyayaH:lyap><XAwuH:gamLz><gaNaH:BvAxih><level:1>
samApIwavAn	nI1<upasarga:sam_Af><kqw_prawyayaH:kwavawu><XAwuH:nI><gaNaH:BAxiH><kqw_pratipadika:samApIwavaw><vargaH:nA><lifgam:puM><viBakwiH:1><vacanam:eka><level:1>
samAropya	rUp1<upasarga:sam_Af><vargaH:avy><kqw_prawyayaH:lyap><XAwuH:rupa><gaNaH:curAxiH><level:1>
samAsAxya	Rax1<upasarga:sam_Af><vargaH:avy><sanAxi_prawyayaH:Nic><kqw_prawyayaH:lyap><XAwuH:RaxL><gaNaH:BvAxiH><level:1>
samAsIxanwi	Rax1<upasarga:sam_Af><prayogaH:karwari><lakAraH:lat><puruRaH:pra><vacanam:bahu><paxI:parasmEpaxI><XAwuH:Raxa><gaNaH:BvAxiH><level:1>
samAxixeSa	xiS1<upasarga:sam_Af><prayogaH:karwari><lakAraH:lit><puruRaH:pra><vacanam:eka><paxI:parasmEpaxI><XAwuH:xiSa><gaNaH:wuxAxiH><level:1>
samBAlaya	Bal1<upasarga:sam><sanAxi_prawyayaH:Nic><prayogaH:karwari><lakAraH:lot><puruRaH:ma><vacanam:eka><paxI:parasmEpaxI><XAwuH:Bala><gaNaH:BvAxiH><level:1>
samBAliwavAn	samBAliwavaw<vargaH:nA><lifgam:puM><viBakwiH:1><vacanam:eka><level:1>
samBAvayew	BU2<upasarga:sam><prayogaH:karwari><lakAraH:viXilif><puruRaH:pra><vacanam:eka><paxI:parasmEpaxI><XAwuH:Buvo><gaNaH:curAxiH><level:1>
samajAyawa	ji1<upasarga:sam><prayogaH:karwari><lakAraH:laf><puruRaH:pra><vacanam:eka><paxI:AwmanepaxI><XAwuH:ji><gaNaH:BvAxiH><level:1>/jan2<upasarga:sam><sanAxi_prawyayaH:Nic><prayogaH:karwari><lakAraH:laf><puruRaH:pra><vacanam:eka><paxI:parasmEpaxI><XAwuH:jan><gaNaH:xivAxiH><level:1>
samakewayawa	kew1<upasarga:sam><prayogaH:karwari><lakAraH:laf><puruRaH:pra><vacanam:eka><paxI:AwmanepaxI><XAwuH:kewa><gaNaH:curAxiH><level:1>
samaqpya	q1<upasarga:sam><vargaH:avy><sanAxi_prawyayaH:Nic><kqw_prawyayaH:lyap><XAwuH:q><gaNaH:axAdiH><level:1>
samarpayawu	q1<upasarga:sam><sanAxi_prawyayaH:Nic><prayogaH:karwari><lakAraH:lot><puruRaH:pra><vacanam:eka><paxI:parasmEpaxI><XAwuH:q><gaNaH:BvAxiH><level:1>
samarpiwavAn	samarpiwavaw<vargaH:nA><lifgam:puM><viBakwiH:1><vacanam:eka><level:1>
samarpya	q1<upasarga:sam><vargaH:avy><sanAxi_prawyayaH:Nic><kqw_prawyayaH:lyap><XAwuH:q><gaNaH:BvAxiH><level:1>
samarpyewa	arpa1<upasarga:sam><prayogaH:karwari><lakAraH:viXilif><puruRaH:pra><vacanam:eka><paxI:AwmanepaxI><XAwuH:q><gaNaH:BvAxiH><level:1>
samavAhayaw	vAh1<upasarga:sam><prayogaH:karwari><lakAraH:laf><puruRaH:pra><vacanam:eka><paxI:pasamEpaxI><XAwuH:vAhi><gaNaH:BvAxiH><level:1>
samawIwya	i1<upasarga:sam_awi><vargaH:avy><kqw_prawyayaH:lyap><XAwuH:i><gaNaH:axAxih><level:1>
sammAnayawi	mAna1<upasarga:sam><prayogaH:karwari><lakAraH:lat><puruRaH:pra><vacanam:eka><paxI:parasmEpaxI><XAwuH:mAna><gaNaH:curAxiH><level:1>
sammohayan	sammohayaw<vargaH:nA><lifgam:puM><viBakwiH:1><vacanam:eka><level:1>
sammuKe	sammuKa<vargaH:nA><lifgam:puM><viBakwiH:7><vacanam:eka><level:1>
sampAxayAmaH	pax1<upasarga:sam><prayogaH:karwari><lakAraH:lat><puruRaH:u><vacanam:bahu><paxI:parasmEpaxI><XAwuH:paxa><gaNaH:BvAxiH><level:1>
sampAxayanwi	pax1<upasarga:sam><prayogaH:karwari><lakAraH:lat><puruRaH:pra><vacanam:bahu><paxI:parasmEpaxI><XAwuH:pax><gaNaH:curAxiH><level:1>
sampAxayawaH	pax1<upasarga:sam><prayogaH:karwari><lakAraH:lat><puruRaH:pra><vacanam:xvi><paxI:parasmEpaxI><XAwuH:paxa><gaNaH:BvAxiH><level:1>
sampAxya	pax1<upasarga:sam><vargaH:avy><sanAxi_prawyayaH:Nic><kqw_prawyayaH:lyap><XAwuH:paxa><gaNaH:BvAxiH><level:1>
sampaw	sampax<vargaH:nA><lifgam:swrI><viBakwiH:1><vacanam:eka><level:1>
sampawkarAya	sampawkara<vargaH:nA><lifgam:napuM><viBakwiH:4><vacanam:eka><level:1>
samprApwe	Ap1<upasarga:sam_pra><kqw_prawyayaH:kwa><XAwuH:ApLz><gaNaH:svAxiH>samprApwa<vargaH:nA><lifgam:puM><viBakwiH:7><vacanam:eka><level:1>
samprINaya	prI1<upasarga:sam><prayogaH:karwari><lakAraH:lot><puruRaH:ma><vacanam:eka><paxI:parasmEpaxI><XAwuH:prIF><gaNaH:kryAxiH><leve:0>
samprahqRtaH	hqR<upasarga:sam_pra><kqw_prawyayaH:kwa><XAwuH:hqR><gaNaH:xivAxiH>saMprahqRta<vargaH:nA><lifgam:puM><viBakwiH:1><vacanam:eka><level:1>
samprakIrwiwaH	samprakIrwiwa<vargaH:nA><lifgam:puM><viBakwiH:1><vacanam:eka><level:1>
samprekRya	IkR1<upasarga:sam_pra><vargaH:avy><kqw_prawyayaH:lyap><XAwuH:IkRaz><gaNaH:BvAxiH><level:1>
samrAt	samrAj<vargaH:nA><lifgam:puM><viBakwiH:1><vacanam:eka><level:1>
samuwWApya	RWA1<upasarga:sam_uw><vargaH:avy><sanAxi_prawyayaH:Nic><kqw_prawyayaH:lyap><XAwuH:RWA><gaNaH:BvAxiH><level:1>
samuwpanne	pax1<upasarga:sam_uw><kqw_prawyayaH:kwa><XAwuH:paxaz><gaNaH:xivAxiH><kqw_pratipadika:samuwpanna><vargaH:nA><lifgam:puM><viBakwiH:7><vacanam:eka><level:2>
sanwApayawi	wap1<upasarga:sam><sanAxi_prawyayaH:Nic><prayogaH:karwari><lakAraH:lat><puruRaH:pra><vacanam:eka><paxI:parasmEpaxI><XAwuH:ciF><gaNaH:wanAxiH><level:1>
sanwapwaH	wap1<upasarga:sam><kqw_prawyayaH:kwa><XAwuH:wapaz><gaNaH:BvAxiH><kqw_pratipadika:sanwapwa><vargaH:nA><lifgam:puM><viBakwiH:1><vacanam:eka><level:2>
sanwuRta	wuR1<upasarga:sam><kqw_prawyayaH:kwa><lifgam:puM><XAwuH:wuRaz><gaNaH:xivAxiH><level:1>
sanxahawi	xah1<upasarga:sam><prayogaH:karwari><lakAraH:lat><puruRaH:pra><vacanam:eka><paxI:parasmEpaxI><XAwuH:xahaz><gaNaH:BvAxiH><level:1>
sarva	sarva<vargaH:sa><lifgam:puM><viBakwiH:8><vacanam:eka><level:1>
sarvaxAnanxaH	sarvaxAnanxa<vargaH:nA><lifgam:puM><viBakwiH:1><vacanam:eka><level:1>
sasuKam	suKa<upasarga:sa><vargaH:nA><lifgam:napuM><viBakwiH:1><vacanam:eka><level:1>
saviswaram	saviswaram<vargaH:avy><level:1>
savyasAcin	savyasAcin<vargaH:nA><lifgam:puM><viBakwiH:8><vacanam:eka><level:1>
sawkromi	kq3<upasarga:saw><prayogaH:karwari><lakAraH:lat><puruRaH:u><vacanam:eka><paxI:parasmEpaxI><XAwuH:dukqF><gaNaH:BvAxiH><level:1>
sawwama	sawwama<vargaH:nA><lifgam:puM><viBakwiH:8><vacanam:eka><level:1>
sawwvavawAm	sawwvavaw<vargaH:nA><lifgam:puM><viBakwiH:6><vacanam:bahu><level:1>
saxqS	saxqS<vargaH:nA><lifgam:puM><viBakwiH:1><vacanam:eka><level:1>
saxqSA	saxqSA<vargaH:nA><lifgam:swrI><viBakwiH:1><vacanam:eka><level:1>
saxqkRA	saxqkRA<vargaH:nA><lifgam:swrI><viBakwiH:1><vacanam:eka><level:1>
senAnInAm	senAnin<vargaH:nA><lifgam:puM><viBakwiH:6><vacanam:bahu><level:1>
sixXyawi	siX3<prayogaH:karwari><lakAraH:lat><puruRaH:pra><vacanam:eka><paxI:parasmEpaxI><gaNaH:xivAxiH><level:1>
smArayiwvA	smara<vargaH:avy><sanAxi_prawyayaH:Nic><kqw_prawyayaH:kwvA><XAwuH:smara><gaNaH:BvAxiH><level:1>
soDum	saha1<vargaH:avy><kqw_prawyayaH:wumun><XAwuH:Rahaz><gaNaH:BvAxiH><level:1>
sprihayamAnaH	sprihayamAna<vargaH:nA><lifgam:puM><viBakwiH:1><vacanam:eka><level:1>
suXArayawu	Xq1<upasarga:su><sanAxi_prawyayaH:Nic><prayogaH:karwari><lakAraH:lot><puruRaH:pra><vacanam:eka><paxI:parasmEpaxI><XAwuH:Xq><gaNaH:BvAxiH><level:1>
sumanwraH	sumanwra<vargaH:nA><lifgam:puM><viBakwiH:1><vacanam:eka><level:1>
suniSciwam	suniSciwa<vargaH:nA><lifgam:puM><viBakwiH:2><vacanam:eka><level:1>/suniSciwa<vargaH:nA><lifgam:napuM><viBakwiH:1><vacanam:eka><level:1>/suniSciwa<vargaH:nA><lifgam:napuM><viBakwiH:2><vacanam:eka><level:1>
susuKam	susuKa<vargaH:nA><lifgam:napuM><viBakwiH:1><vacanam:eka><level:1>
suvicArya	car1<upasarga:su_vi><vargaH:avy><sanAxi_prawyayaH:Nic><kqw_prawyayaH:lyap><XAwuH:cara><gaNaH:BvAxiH><level:1>
suxuRkaram	suxuRkara<vargaH:nA><lifgam:puM><viBakwiH:2><vacanam:eka><level:1>/suxuRkara<vargaH:nA><lifgam:napuM><viBakwiH:1><vacanam:eka><level:1>/suxuRkara<vargaH:nA><lifgam:napuM><viBakwiH:2><vacanam:eka><level:1>
svAmi	svAmin<vargaH:nA><lifgam:puM><viBakwiH:6><vacanam:eka><level:1>
svIkariRyawi	svIkq1<prayogaH:karwari><lakAraH:lqt><puruRaH:pra><vacanam:eka><paxI:parasmEpaxI><XAwuH:svIkq><gaNaH:wanAxiH><level:1>
svaXarmaH	svaXarma<vargaH:nA><lifgam:puM><viBakwiH:1><vacanam:eka><level:1>
svaXarme	svaXarma<vargaH:nA><lifgam:puM><viBakwiH:7><vacanam:eka><level:1>
svakIyam	svakIya<vargaH:nA><lifgam:napuM><viBakwiH:1><vacanam:eka><level:1>/svakIya<vargaH:nA><lifgam:napuM><viBakwiH:2><vacanam:eka><level:1>
svakam	svaka<vargaH:nA><lifgam:napuM><viBakwiH:2><vacanam:eka><level:1>
svaxan	svaxaw<vargaH:nA><lifgam:puM><viBakwiH:1><vacanam:eka><level:1>
swrI	swrI<vargaH:nA><lifgam:swrI><viBakwiH:1><vacanam:eka><level:1>
uSanA	uSanas<vargaH:nA><lifgam:puM><viBakwiH:1><vacanam:eka><level:1>
uccArayan	uccArayaw<vargaH:nA><lifgam:puM><viBakwiH:1><vacanam:eka><level:1>
uccEHSravasam	uccEHSravasa<vargaH:nA><lifgam:puM><viBakwiH:2><vacanam:eka><level:1>
uddIwum	dI1<vargaH:avy><upasarga:uw><kqw_prawyayaH:wumun><XAwuH:dIf><gaNaH:BvAxiH><level:1>
unmIlayan	mIl1<upasarga:uw><sanAxi_prawyayaH:Nic><kqw_prawyayaH:Sawq><XAwuH:mIlaz><gaNaH:BvAxiH><kqw_pratipadika:unmIlayaw><vargaH:nA><lifgam:puM><viBakwiH:1><vacanam:1>
unmiRan	unmiRaw<vargaH>nA><lifgam:puM><viBakwiH:1><vacanam:eka><level:1>
unmukwam	muc1<upasarga:uw><kqw_prawyayaH:kwa><XAwuH:mucLz><gaNaH:BvAxiH>unmukwa<vargaH:nA><lifgam:puM><viBakwiH:2><vacanam:eka><level:1>
upArjiwaH	upArjiwa<vargaH:nA><lifgam:puM><viBakwiH:1><vacanam:eka><level:1>
upArjiwam	upArjiwa<vargaH:nA><lifgam:napuM><viBakwiH:1><vacanam:eka><level:1>/upArjiwa<vargaH:nA><lifgam:napuM><viBakwiH:2><vacanam:eka><level:1>/upArjiwa<vargaH:nA><lifgam:puM><viBakwiH:2><vacanam:eka><level:1>
upArjiwavAn	upArjiwavaw<vargaH:nA><lifgam:puM><viBakwiH:1><vacanam:eka><level:1>
upAsva	Asa1<upasarga:upa><prayogaH:karwari><lakAraH:lot><puruRaH:ma><vacanam:eka><paxI:AtmanepaxI><XAwuH:Asa><gaNaH:axAxiH><level:1>
upAveSayam	viS1<upasarga:upa_Af><sanAxi_prawyayaH:Nic><prayogaH:karwari><lakAraH:laf><puruRaH:u><vacanam:eka><paxI:parasmEpaxI><XAwuH:viSa><gaNaH:wuxAxiH><level:1>
upaXAraya	Xq1<upasarga:upa><sanAxi_prawyayaH:Nic><prayogaH:karwari><lakAraH:lot><puruRaH:ma><vacanam:eka><paxI:parasmEpaxI><XAwuH:XqF><gaNaH:BvAxiH><level:1>/Xq2<upasarga:upa><sanAxi_prawyayaH:Nic><prayogaH:karwari><lakAraH:lot><puruRaH:ma><vacanam:eka><paxI:parasmEpaxI><XAwuH:Xqf><gaNaH:BvAxiH><level:1>
upahAsayawi	has1<upasarga:upa><sanAxi_prawyayaH:Nic><prayogaH:karwari><lakAraH:lat><puruRaH:pra><vacanam:eka><paxI:parasmEpaxI><XAwuH:hasaz><gaNaH:BvAxiH><level:1>
upajuhvawi	hu1<upasarga:upa><prayogaH:karwari><lakAraH:lat><puruRaH:pra><vacanam:bahu><paxI:parasmEpaxI><XAwuH:hu><gaNaH:juhowyAxiH><level:1>
upakArArWam	upakAra<vargaH:nA><lifgam:napuM><viBakwiH:1><vacanam:eka><level:1>
upakAriNe	upakArin<vargaH:nA><lifgam:puM><viBakwiH:4><vacanam:eka><level:1>
upakalpayAmi	kalp1<upasarga:upa><prayogaH:karwari><lakAraH:lat><puruRaH:uwa><vacanam:eka><paxI:parasmEpaxI><XAwuH:kLp><gaNaH:ruXAxiH><level:1>
upakqpayAmi	kqp1<upasarga:upa><prayogaH:karwari><lakAraH:lat><puruRaH:u><vacanam:eka><paxI:parasmEpaxI><XAwuH:kqpU><gaNaH:BvAxiH><level:1>
upakramewa	kram1<upasarga:upa><prayogaH:karwari><lakAraH:viXilif><puruRaH:pra><vacanam:eka><paxI:AwmanepaxI><XAwuH:kram><gaNaH:BvAxiH><level:1>/kram1<upasarga:upa><prayogaH:karmaNi><lakAraH:viXilif><puruRaH:ma><vacanam:ba><paxI:paramEpaxI><XAwuH:kram><gaNaH:BvAxiH><level:1>
upapawawi	paw1<upasarga:upa><prayogaH:karwari><lakAraH:lat><puruRaH:pra><vacanam:eka><paxI:parasmEpaxI><XAwuH:pawL><gaNaH:BvAxiH><level:1>
uparamew	ram1<upasarga:upa><prayogaH:karwari><lakAraH:viXilif><puruRaH:pra><vacanam:eka><paxI:AwmanepaxI><XAwuH:ramuz><gaNaH:BvAxiH><level:1>
upasWApayanwi	RWA1<upasarga:upa><sanAxi_prawyayaH:Nic><prayogaH:karwari><lakAraH:lat><puruRaH:pra><vacanam:bahu><paxI:parasmEpaxI><XAwuH:RWA><gaNaH:BvAxiH><level:1>
upasWApiwavAn	upasWApiwavaw<vargaH:nA><lifgam:puM><viBakwiH:1><vacanam:eka><level:1>
upasarpAvaH	sqp1<upasarga:upa><prayogaH:karwari><lakAraH:lat><puruRaH:u><vacanam:xvi><paxI:parasmEpaxI><XAwuH:sqpa><gaNaH:BvAxiH><level:1>
upaspqSan	spqS1<upasarga:upa><kqw_prawyayaH:Sawq_lat><XAwuH:spqSaz><gaNaH:wuxAxiH>upaspqSaw<vargaH:nA><lifgam:puM><viBakwiH:1><vacanam:eka><level:1>
upawiRTawsu	RWA1<upasarga:upa><kqw_prawyayaH:Sawq_lat><XAwuH:RWA><gaNaH:axAxiH><kqw_pratipadika:upawiRTaw><vargaH:nA><lifgam:puM><viBakwiH:7><vacanam:1>/RWA1<upasarga:upa><kqw_prawyayaH:Sawq_lat><XAwuH:RWA><gaNaH:axAxiH><kqw_pratipadika:upawiRTaw><vargaH:nA><lifgam:napuM><viBakwiH:7><vacanam:1>
upaxiSyamAnam	upaxiSyamAna<vargaH:nA><lifgam:puM><viBakwiH:2><vacanam:eka><level:1>
upayujyawe	yuj2<upasarga:upa><prayogaH:karwari><lakAraH:lat><puruRaH:pra><vacanam:eka><paxI:parasmEpaxI><XAwuH:yujir><gaNaH:ruXAxiH><level:1>
upekRiwavAn	upekRiwavaw<vargaH:nA><lifgam:puM><viBakwiH:1><vacanam:eka><level:1>
upekRiwavanwO	upekRiwavaw<vargaH:nA><lifgam:puM><viBakwiH:1><vacanam:xvi><level:1>
upekRiwavanwaH	upekRiwavaw<vargaH:nA><lifgam:puM><viBakwiH:1><vacanam:bahu><level:1>
uwWApayawi	RWA1<upasarga:uw><sanAxi_prawyayaH:Nic><prayogaH:karwari><lakAraH:lat><puruRaH:pra><vacanam:eka><paxI:parasmEpaxI><XAwuH:svIkq><gaNaH:BvAxiH><level:1>
uwWAsyawi	RWA1<upasarga:uw><prayogaH:karwari><lakAraH:lqt><puruRaH:pra><vacanam:eka><paxI:parasmEpaxI><XAwuH:RWA1><gaNaH:curAxiH><level:1>
uwpAxayAmi	pax1<upasarga:uw><sanAxi_prawyayaH:Nic><prayogaH:karwari><lakAraH:lat><puruRaH:u><vacanam:eka><paxI:parasmEpaxI><XAwuH:paxa><gaNaH:kryAxiH><level:1>
uwpAxayanwi	paw1<upasarga:uw><sanAxi_prawyayaH:Nic><prayogaH:karwari><lakAraH:lat><puruRaH:pra><vacanam:bahu><paxI:parasmEpaxI><XAwuH:pawl><gaNaH:BvAxiH><level:1>
uwpawanwi	paw1<upasarga:uw><prayogaH:karwari><lakAraH:lat><puruRaH:pra><vacanam:bahu><paxI:parasmEpaxI><XAwuH:pwL><gaNaH:BvAxiH><level:1>
uwpaxyawe	pax1<upasarga:uw><prayogaH:karwari><lakAraH:lat><puruRaH:pra><vacanam:eka><paxI:AwmanepaxI><XAwuH:paxL><gaNaH:xivAxiH><level:1>
uwsAxyanwe	Rax1<upasarga:uw><sanAxi_prawyayaH:Nic><prayogaH:karmaNi><lakAraH:lat><puruRaH:pra><vacanam:bahu><paxI:AwmanepaxI><XAwuH:RaxLz><gaNaH:BvAxiH><level:1>
uwsIxeyuH	sax1<upasarga:uw><prayogaH:karwari><lakAraH:viXilif><puruRaH:pra><vacanam:bahu><paxI:parasmEpaxI><XAwuH:RaxLz><gaNaH:BvAxiH><level:1>
uwsargeNa	uwsarga<vargaH:nA><lifgam:puM><viBakwiH:3><vacanam:eka><level:1>
uwsasarja	sqj1<upasarga:uw><prayogaH:karwari><lakAraH:lit><puruRaH:pra><vacanam:eka><paxI:AtmanepaxI><XAwuH:sqja><gaNaH:BvAxiH><level:1>
uwsmayiwvA	smi1<upasarga:uw><vargaH:avy><kqw_prawyayaH:kwvA><XAwuH:smif><gaNaH:BvAxiH><level:1>
uwsqjAmi	sqj2<upasarga:uw><prayogaH:karwari><lakAraH:lat><puruRaH:u><vacanam:eka><paxI:parasmEpaxI><XAwuH:sqjaz><gaNaH:wuxAxiH><level:1>
uwwarA	uwwara<vargaH:avy><waxXiwa_prawyayaH:Ac><level:1>
uwwarAhi	uwwara<vargaH:avy><waxXiwa_prawyayaH:Ahi><level:1>
uwwiRTamAnaH	uwwiRTamAna<vargaH:nA><lifgam:puM><viBakwiH:1><vacanam:eka><level:1>
uxGoRayan	uxGoRayaw<vargaH:nA><lifgam:puM><viBakwiH:1><vacanam:eka><level:1>
uxGoRayanwam	uxGoRayaw<vargaH:nA><lifgam:puM><viBakwiH:2><vacanam:eka><level:1>
uxGoRayanwi	GuR1<upasarga:uw><prayogaH:karwari><lakAraH:lat><puruRaH:pra><vacanam:bahu><paxI:parasmEpaxI><XAwuH:GuRir><gaNaH:curAxiH><level:1>
uxGoRiwaH	uxGoRiwa<vargaH:nA><lifgam:puM><viBakwiH:1><vacanam:eka><level:1>
uxGoRya	GuR1<upasarga:uw><vargaH:avy><kqw_prawyayaH:lyap><XAwuH:GuRi><gaNaH:BvAxiH><level:1>/GuR2<upasarga:uw><vargaH:avy><kqw_prawyayaH:lyap><XAwuH:GuRir><gaNaH:BvAxiH><level:0>/GuR3<upasarga:uw><vargaH:avy><kqw_prawyayaH:lyap><XAwuH:GuRir><gaNaH:curAxiH><level:0>
uxGuRtam	GuR2<upasarga:ux><kqw_prawyayaH:kwa><XAwuH:GuRizr><gaNaH:BvAxiH><kqw_pratipadika:uxGuRta><vargaH:nA><lifgam:puM><viBakwiH:1><vacanam:2>
uxXarew	hq1<upasarga:uw><prayogaH:karwari><lakAraH:viXilif><puruRaH:pra><vacanam:eka><paxI:parasmEpaxI><XAwuH:hqF><gaNaH:BvAxiH><level:1>/Xq1<upasarga:uw><prayogaH:karwari><lakAraH:viXilif><puruRaH:pra><vacanam:eka><paxI:parasmEpaxI><XAwuH:XqF><gaNaH:BvAxiH><level:1>
uxaGoRayaw	GuR1<upasarga:uw><prayogaH:karwari><lakAraH:laf><puruRaH:pra><vacanam:eka><paxI:parasmEpaxI><XAwuH:GuRir><gaNaH:curAxiH><level:1>
uxaGoRyaw	GuR1<upasarga:uw><prayogaH:karwari><lakAraH:laf><puruRaH:pra><vacanam:eka><paxI:parasmEpaxI><XAwuH:GuRir><gaNaH:curAxiH><level:1>
uxvignawA	uxvigna<vargaH:avy><waxXiwa_prawyayaH:wal><lifgam:swrI><viBakwiH:1><vacanam:eka><level:1>
uxvijew	vij2<upasarga:uw><prayogaH:karwari><lakAraH:viXilif><puruRaH:pra><vacanam:eka><paxI:parasmEpaxI><XAwuH:ozvijIz><gaNaH:wuxAxiH><level:1>
uxyanwam	uxyaw<vargaH:nA><lifgam:puM><viBakwiH:2><vacanam:eka><level:1>
vAyuyAnAni	vAyuyAna<vargaH:nA><lifgam:napuM><viBakwiH:1><vacanam:bahu><level:1>
vIjayAmi	Ij1<upasarga:vi><sanAxi_prawyayaH:Nic><prayogaH:karwari><lakAraH:lat><puruRaH:u><vacanam:eka><paxI:parasmEpaxI><XAwuH:ija><gaNaH:BvAxiH><level:1>
vIkRanwe	IkR1<upasarga:vi><prayogaH:karwari><lakAraH:lat><puruRaH:pra><vacanam:bahu><paxI:AwmanepaxI><XAwuH:IkRaz><gaNaH:BvAxiH><level:1>
vacArayanwi	cara1<upasarga:vi><sanAxi_prawyayaH:Nic><prayogaH:karwari><lakAraH:lat><puruRaH:pra><vacanam:bahu><paxI:parasmEpaxI><XAwuH:cara><gaNaH:BvAdiH><level:1>
vagAhya	gAh1<upasarga:ava><vargaH:avy><kqw_prawyayaH:lyap><XAwuH:gAhUz><gaNaH:BvAxiH><level:2>
varayAmAsa	vq2<upasarga:X><prayogaH:karwari><lakAraH:lit><puruRaH:pra><vacanam:eka><paxI:parasmEpaxI><XAwuH:vq><gaNaH:axAxiH><level:1>
varweyam	vqw1<prayogaH:karwari><lakAraH:viXilif><puruRaH:u><vacanam:eka><paxI:AwmanepaxI><gaNaH:BvAxiH><level:1>
vasawim	vasawi<vargaH:nA><lifgam:swrI><viBakwiH:2><vacanam:eka><level:1>
vgqhiNaH	vqghin<vargaH:nA><lifgam:puM><viBakwiH:1><vacanam:bahu><level:1>
viRNuSarmA	viRNuSarman<vargaH:nA><lifgam:puM><viBakwiH:1><vacanam:eka><level:1>
viRNumiwraH	viRNumiwra<vargaH:nA><lifgam:puM><viBakwiH:1><vacanam:eka><level:1>
viRNumiwrasya	viRNumiwra<vargaH:nA><lifgam:puM><viBakwiH:6><vacanam:eka><level:1>
viSiRyawe	SAs1<upasarga:vi><prayogaH:karwari><lakAraH:lat><puruRaH:pra><vacanam:eka><paxI:AwmanepaxI><XAwuH:SAs><gaNaH:axAxiH><level:1>
viSoXya	SuX1<upasarga:vi><vargaH:avy><kqw_prawyayaH:lyap><XAwuH:SuX>u<gaNaH:xivAxiH><level:1>
viSramiwum	Sram1<upasarga:vi><vargaH:avy><kqw_prawyayaH:wumun><XAwuH:Sramu><gaNaH:xivAxiH><level:1>
viSvAsayAmi	Svas<upasarga:vi><sanAxi_prawyayaH:Nic><prayogaH:karwari><lakAraH:lat><puruRaH:u><vacanam:eka><paxI:parasmEpaxI><XAwuH:Svasuz><gaNaH:axAxiH><level:1>
vicAlayew	cal1<upasarga:vi><sanAxi_prawyayaH:Nic><prayogaH:karwari><lakAraH:viXilif><puruRaH:pra><vacanam:eka><paxI:parasmEpaxI><XAwuH:calaz><gaNaH:BvAxiH><level:1>/cal3<upasarga:vi><prayogaH:karwari><lakAraH:viXilif><puruRaH:pra><vacanam:eka><paxI:parasmEpaxI><XAwuH:calaz><gaNaH:curAxiH><level:1>
vicAlyawe	cal3<upasarga:vi><prayogaH:karmaNi><lakAraH:lat><puruRaH:pra><vacanam:eka><paxI:AwmanepaxI><XAwuH:calaz><gaNaH:curAxiH><level:1>
vigawajvaraH	vigawajvara<upasarga:vi><vargaH:nA><lifgam:puM><viBakwiH:1><vacanam:eka><level:1>
vijAnIwaH	jFA1<upasarga:vi><prayogaH:karwari><lakAraH:lat><puruRaH:p><vacanam:xvi><paxI:parasmEpaxI><XAwuH:jFA><gaNaH:kryAxiH><level:1>
vijAnIyAm	jFA1<upasarga:vi><prayogaH:karwari><lakAraH:viXilif><puruRaH:u><vacanam:eka><paxI:parasEpaxI><XAwuH:jFA><gaNaH:kryAxiH><level:1>
vijFApayAmAsa	jFA1<upasarga:vi><sanAxi_prawyayaH:Nic><prayogaH:karwari><lakAraH:lit><puruRaH:pra><vacanam:eka><paxI:parasmEpaxI><XAwuH:jFA><gaNaH:curAxiH><level:1>
vijFApayanwaH	vijFApayaw<upasarga:vi><vargaH:nA><lifgam:puM><viBakwiH:1><vacanam:bahu><level:1>
vikIrNavAn	kQ1<upasarga:vi><kqw_prawyayaH:kwavawu><XAwuH:kQ><gaNaH:wuxAxiH><kqw_pratipadika:vikIrNavaw><vargaH:nA><lifgam:puM><viBakwiH:1><vacanam:eka><level:1>
vikariRyawi	kQ1<upasarga:vi><prayogaH:karwari><lakAraH:lqt><puruRaH:pra><vacanam:eka><paxI:parasmEpaxI><XAwuH:kQ><gaNaH:wuxAxiH><level:1>
vikrIya	krI1<upasarga:vi><vargaH:avy><kqw_prawyayaH:lyap><XAwuH:dukrIF><gaNaH:kryAxiH><level:1>
vilApayase	lap1<upasarga:vi><prayogaH:karwari><lakAraH:lot><puruRaH:ma><vacanam:eka><paxI:parasmEpaxI><XAwuH:lap><gaNaH:BvAxiH><level:1>
vilakRaNA	vilakRaNA<vargaH:nA><lifgam:swrI><viBakwiH:1><vacanam:eka><level:1>
vilakRaNaH	vilakRaNa<vargaH:nA><lifgam:puM><viBakwiH:1><vacanam:eka><level:1>
viliyamaH	viliyama<vargaH:nA><lifgam:puM><viBakwiH:1><vacanam:eka><level:1>
vilopayawi	lup1<upasarga:vi><sanAxi_prawyayaH:Nic><prayogaH:karwari><lakAraH:lat><puruRaH:pra><vacanam:eka><paxI:parasmEpaxI><XAwuH:svIkq><gaNaH:wanAxiH><level:1>
vimUDAwmA	vimUDAwman<vargaH:nA><lifgam:puM><viBakwiH:1><vacanam:eka><level:1>
vimohayawi	muh1<upasarga:vi><sanAxi_prawyayaH:Nic><prayogaH:karwari><lakAraH:lat><puruRaH:pra><vacanam:eka><paxI:parasmEpaxI><XAwuH:muhaz><gaNaH:xivAxiH><level:1>
vimokRyase	muc1<upasarga:vi><prayogaH:karwari><lakAraH:lqt><puruRaH:ma><vacanam:eka><paxI:AwmanepaxI><XAwuH:mucLz><gaNaH:wuxAxiH><level:1>
vimuFcawi	muc1<upasarga:vi><prayogaH:karwari><lakAraH:lat><puruRaH:pra><vacanam:eka><paxI:parasmEpaxI><XAwuH:mucLz><gaNaH:wuxAxiH><level:1>
vinASinam	vinASin<vargaH:nA><lifgam:puM><viBakwiH:2><vacanam:eka><level:1>
vinaSyanwam	vinaSyaw<vargaH:nA><lifgam:puM><viBakwiH:2><vacanam:eka><level:1>
vinaSyanwi	NaS1<upasarga:vi><prayogaH:karwari><lakAraH:lat><puruRaH:pra><vacanam:bahu><paxI:parasmEpaxI><XAwuH:NaSaz><gaNaH:xivAxiH>
vinaSyawi	NaS1<upasarga:vi><prayogaH:karwari><lakAraH:lat><puruRaH:pra><vacanam:eka><paxI:parasmEpaxI><XAwuH:NaSaz><gaNaH:xivAxiH>
vinaSyawsu	vinaSyaw<vargaH:nA><lifgam:puM><viBakwiH:7><vacanam:bahu><level:1>
vinafkRyasi	NaS1<upasarga:vi><prayogaH:karwari><lakAraH:lqt><puruRaH:ma><vacanam:eka><paxI:parasmEpaxI><XAwuH:NaSaz><gaNaH:xivAxiH><level:1>
vininxan	vininxaw<vargaH:nA><lifgam:puM><viBakwiH:1><vacanam:eka><level:1>
vinirmiwam	mA1<upasarga:vi_nir><kqw_prawyayaH:kwa><XAwuH:mA><gaNaH:axAxiH><kqw_pratipadika:vinirmiwa><vargaH:nA><lifgam:puM><viBakwiH:1><vacanam:2>
vinirmukwAH	vinirmukta<vargaH:nA><lifgam:puM><viBakwiH:1><vacanam:bahu><level:1>/vinirmuktA<vargaH:nA><lifgam:swrI><viBakwiH:1><vacanam:bahu><level:1>
viniyojiwavAn	viniyojiwavaw<vargaH:nA><lifgam:puM><viBakwiH:1><vacanam:eka><level:1>
virUpiwA	virUpiwA<vargaH:nA><lifgam:swrI><viBakwiH:1><vacanam:eka><level:1>
virUpiwaH	virUpiwa<vargaH:nA><lifgam:puM><viBakwiH:1><vacanam:eka><level:1>
viramawi	ram1<upasarga:vi><prayogaH:karwari><lakAraH:lat><puruRaH:pra><vacanam:eka><paxI:parasmEpaxI><XAwuH:ramu><gaNaH:BvAxiH><level:1>
viramawu	ram1<upasarga:vi><prayogaH:karwari><lakAraH:lot><puruRaH:pra><vacanam:eka><paxI:parasmEpaxI><XAwuH:ramu><gaNaH:BvAxiH><level:1>
virarAma	ram1<upasarga:vi><prayogaH:karwari><lakAraH:lit><puruRaH:pra><vacanam:eka><paxI:AwmanepaxI><XAwuH:ramuz><gaNaH:BvAxiH><level:1>
vivAsayAmAsa	vas1<upasarga:vi><prayogaH:karwari><lakAraH:lit><puruRaH:pra><vacanam:eka><paxI:AwmanepaxI><XAwuH:vas><gaNaH:curAxiH><level:1>
vixArya	xQ1<vargaH:avy><sanAxi_prawyayaH:Nic><kqw_prawyayaH:lyap><XAwuH:xQ><gaNaH:curAdiH><level:1>
vyApAxayasi	pax1<sanAxi_prawyayaH:Nic><upasarga:vi_Af><prayogaH:karwari><lakAraH:lat><puruRaH:ma><vacanam:eka><paxI:parasmEpaxI><XAwuH:paxa><gaNaH:BvAxiH><level:1>
vyApAxiwaH	pax1<upasarga:vi_Af><kqw_prawyayaH:kwa><XAwuH:paxaz><gaNaH:xivAxiH><kqw_pratipadika:vyApAxiwa><vargaH:nA><lifgam:puM><viBakwiH:1><vacanam:eka><level:1>
vyApAxiwavAn	pax1<upasarga:vi_Af><kqw_prawyayaH:kwavawu><XAwuH:paxaz><gaNaH:xivAxiH><kqw_pratipadika:vyApAxiwavaw><vargaH:nA><lifgam:puM><viBakwiH:1><vacanam:eka><level:1>
vyaBURayawa	BUR1<upasarga:vi><prayogaH:karwari><lakAraH:laf><puruRaH:pra><vacanam:eka><paxI:AwmanepaxI><XAwuH:BURa><gaNaH:curAxiH><level:1>
vyaWanwi	vyaW1<prayogaH:karwari><lakAraH:lat><puruRaH:pra><vacanam:bahu><paxI:parasmEpaxI><gaNaH:BvAxiH><level:1>
vyajeRta	ji1<upasarga:vi><prayogaH:karwari><lakAraH:luf><puruRaH:pra><vacanam:eka><paxI:AwmanepaxI><XAwuH:jI><gaNaH:BvAxiH><level:1>
vyajijFapan	jFA<upasarga:vi><prayogaH:karwari><lakAraH:laf><puruRaH:pra><vacanam:bahu><paxI:parasmEpaxI><XAwuH:jFA><gaNaH:BvAxiH><level:1>
vyanunAxayan	<kqw_XAwu:Nax2><upasarga:vi_anu><kqw_prawyayaH:Sawq_lat><XAwuH:Naxaz><gaNaH:curAxiH>vyanunAxayaw<vargaH:nA><lifgam:puM><viBakwiH:1><vacanam:eka><level:1>
vyaramaw	ram1<upasarga:vi><prayogaH:karwari><lakAraH:laf><puruRaH:pra><vacanam:eka><paxI:parasmEpaxI><XAwuH:ramu><gaNaH:BvAxiH><level:1>
vyaramayaw	ram1<upasarga:vi><prayogaH:Nic><lakAraH:laf><puruRaH:pra><vacanam:eka><paxI:parasmEpaxI><XAwuH:ramu><gaNaH:BvAxiH><level:1>
vyasarjayaw	sq2<upasarga:vi><prayogaH:karwari><lakAraH:laf><puruRaH:pra><vacanam:eka><paxI:parasmEpaxI><XAwuH:sqj><gaNaH:wuxAxiH><level:1>
vyaxArayaw	xQ2<upasarga:vi><sanAxi_prawyayaH:Nic><prayogaH:karwari><lakAraH:laf><puruRaH:pra><vacanam:eka><paxI:parasmEpaxI><XAwuH:xQ><gaNaH:kryAxiH><level:1>
walavaw	walava<vargaH:nA><lifgam:napuM><viBakwiH:1><vacanam:eka><level:1>/walava<vargaH:nA><lifgam:napuM><viBakwiH:2><vacanam:eka><level:1>
wapasyasi	wap2<prayogaH:karwari><lakAraH:lqt><puruRaH:ma><vacanam:eka><paxI:parasmEpaxI><gaNaH:xivAxiH><level:1>
wasWivaH	wasWivas<vargaH:nA><lifgam:napuM><viBakwiH:2><vacanam:eka><level:1>
wasmAx	waw<vargaH:sa><lifgam:puM><viBakwiH:5><vacanam:eka><level:1>
wawam	wan1<kqw_prawyayaH:kwa><XAwuH:wanuz><gaNaH:wanAxiH><kqw_pratipadika:wawa><lifgam:napuM><viBakwiH:1><vacanam:eka><level:1>
wriviXaH	wriviXa<vargaH:nA><lifgam:puM><viBakwiH:1><vacanam:eka><level:1>
wriviXam	wriviXa<vargaH:nA><lifgam:puM><viBakwiH:2><vacanam:eka><level:1>
wvaramANAH	wvar1<kqw_prawyayaH:kwa><XAwuH:FiwvarAz><gaNaH:BvAxiH><kqw_pratipadika:wvaramANa><vargaH:nA><lifgam:puM><viBakwiH:1><vacanam:bahu><level:1>/wvaramANa<vargaH:nA><lifgam:puM><viBakwiH:1><vacanam:bahu><level:1>
wyAjayiwum	wyaj1<vargaH:avy><sanAxi_prawyayaH:Nic><kqw_prawyayaH:wumun><XAwuH:wyaja><gaNaH:BvAxiH><level:1>
xApayiwvA	xAp1<vargaH:avy><kqw_prawyayaH:kwvA><XAwuH:xApa><gaNaH:curAxiH><level:1>
xIpaH	xIpa<vargaH:nA><lifgam:puM><viBakwiH:1><vacanam:eka><level:1>
xUram	xUram<vargaH:avy><level:1>
xaNdiwaH	xaNda1<vargaH:nA><kqw_prawyayaH:kwa><XAwuH:xaNda><gaNaH:curAxiH><lifgam:puM><viBakwiH:1><vacanam:eka><level:1>
xahyawi	xah1<prayogaH:karmaNi><lakAraH:lat><puruRaH:pra><vacanam:eka><paxI:parasmEpaxI><gaNaH:BvAxiH><level:1>
xamayawAm	xamayaw<vargaH:nA><lifgam:puM><viBakwiH:6><vacanam:bahu><level:1>
xampawI	xampawI<vargaH:nA><lifgam:swrI><viBakwiH:2><vacanam:xvi><level:1>/xampawI<vargaH:nA><lifgam:swrI><viBakwiH:1><vacanam:xvi><level:1>
xanxahyawe	xah1<sanAxi_prawyayaH:yaf><prayogaH:karwari><lakAraH:lat><puruRaH:pra><vacanam:eka><paxI:parasmEpaxI><XAwuH:xah><gaNaH:BvAxiH><level:1>
xarSanaH	xarSana<vargaH:nA><lifgam:puM><viBakwiH:1><vacanam:eka><level:1>
xarSayan	xqS1<kqw_prawyayaH:Sawq_lat><XAwuH:xqSizr><gaNaH:BvAxiH>xarSayaw<vargaH:nA><lifgam:puM><viBakwiH:1><vacanam:eka><level:1>
xarSayiwum	xqS1<vargaH:avy><sanAxi_prawyayaH:Nic><kqw_prawyayaH:wumun><XAwuH:xqSir><gaNaH:BvAxiH><level:1>
xarSayiwvA	xqS1<vargaH:avy><sanAxi_prawyayaH:Nic><kqw_prawyayaH:kwvA><XAwuH:xqSr><gaNaH:BvAxiH><level:1>
xarSinaH	xarSin<vargaH:nA><lifgam:puM><viBakwiH:1><vacanam:bahu><level:1>/xarSin<vargaH:nA><lifgam:puM><viBakwiH:2><vacanam:bahu><level:1>/xarSin<vargaH:nA><lifgam:puM><viBakwiH:5><vacanam:eka><level:1>/xarSin<vargaH:nA><lifgam:puM><viBakwiH:6><vacanam:eka><level:1>
xarSiwaH	xqS1<vargaH:nA><sanAxi_prawyayaH:Nic><kqw_prawyayaH:kwa><XAwuH:xqS><gaNaH:BvAxiH>xarSiwa<lifgam:puM><viBakwiH:1><vacanam:eka><level:1>/
xarSiwam	xqS1<vargaH:nA><sanAxi_prawyayaH:Nic><kqw_prawyayaH:kwa><XAwuH:xqS><gaNaH:BvAxiH>xarSiwa<lifgam:puM><viBakwiH:1><vacanam:eka><level:1>/xqS1<vargaH:nA><sanAxi_prawyayaH:Nic><kqw_prawyayaH:kwa><XAwuH:xqS><gaNaH:BvAxiH>xarSiwa<lifgam:napuM><viBakwiH:1><vacanam:eka><level:1>/xqS1<vargaH:nA><sanAxi_prawyayaH:Nic><kqw_prawyayaH:kwa><XAwuH:xqS><gaNaH:BvAxiH>xarSiwa<lifgam:napuM><viBakwiH:2><vacanam:xvi><level:1>
xarSiwavAn	xqS1<sanAxi_prawyayaH:Nic><kqw_prawyayaH:kwavawu><XAwuH:xqSizr><gaNaH:BAxiH><kqw_pratipadika:xarSiwavaw><vargaH:nA><lifgam:puM><viBakwiH:1><vacanam:eka><level:1>
xehikam	xehika<vargaH:nA><lifgam:napuM><viBakwiH:2><vacanam:eka><level:1>
xevayajaH	xevayaja<vargaH:nA><lifgam:puM><viBakwiH:1><vacanam:eka><level:1>
xeveSa	xeveSa<vargaH:nA><lifgam:puM><viBakwiH:8><vacanam:eka><level:1>
xixqkRuH	xqS1<sanAxi_prawyayaH:san><kqw_prawyayaH:u><XAwuH:xqSizr><gaNaH:BvAxiH>xixqkRu<vargaH:nA><lifgam:puM><viBakwiH:1><vacanam:eka><level:1>
xravyamayAw	xravyamaya<vargaH:nA><lifgam:puM><viBakwiH:5><vacanam:eka><level:1>
xrumAyawe	xruma<prayogaH:karwari><lakAraH:lat><puruRaH:pra><vacanam:eka><paxI:parasmEpaxI><gaNaH:nAmaXAwu><level:1>
xurBikRam	xurBikRa<vargaH:nA><lifgam:napuM><viBakwiH:2><vacanam:eka><level:1>/xurBikRa<vargaH:nA><lifgam:napuM><viBakwiH:1><vacanam:eka><level:1>
xurBikRyam	xurBikRya<vargaH:nA><lifgam:napuM><viBakwiH:1><vacanam:eka><level:1>
xurmeXasaH	xurmeXas<vargaH:nA><lifgam:puM><viBakwiH:1><vacanam:bahu><level:1>
xviXA	xvi<vargaH:avy><waxXiwa_prawyayaH:XA><level:1>
xyowiwAni	xyowiwa<vargaH:nA><lifgam:napuM><viBakwiH:1><vacanam:bahu><level:1>/xyowiwa<vargaH:nA><lifgam:napuM><viBakwiH:2><vacanam:bahu><level:1>
yApayanwO	yA1<sanAxi_prawyayaH:Nic><kqw_prawyayaH:kwavawu><XAwuH:yA><gaNaH:axAxiH><kqw_pratipadika:yApayaw><vargaH:nA><lifgam:puM><viBakwiH:1><vacanam:xvi><level:1>/yA1<sanAxi_prawyayaH>Nic><kqw_prawyayaH:kwavawu><XAwuH:yA><gaNaH:axAxiH><kqw_pratipadika:yApayaw><vargaH:nA><lifgam:puM><viBakwiH:2><vacanam:xvi><level:1>
yApayiwum	yA1<vargaH:avy><sanAxi_prawyayaH:Nic><kqw_prawyayaH:wumun><XAwuH:yA><gaNaH:axAxiH><level:1>
yaRtikA	yaRtikA<vargaH:nA><lifgam:swrI><viBakwiH:1><vacanam:eka><level:1>
yaRtikayA	yaRtikA<vargaH:nA><lifgam:swrI><viBakwiH:3><vacanam:eka><level:1>
yaWAkaWaFciw	yaWAkaWaFciw<vargaH:avy><level:1>
yajFaxawwaH	yajFaxawwa<vargaH:nA><lifgam:puM><viBakwiH:1><vacanam:eka><level:1>
yawanwaH	yawaw<vargaH:nA><lifgam:puM><viBakwiH:1><vacanam:bahu><level:1>
yawanwi	yaw1<prayogaH:karwari><lakAraH:lat><puruRaH:pra><vacanam:bahu><paxI:parasmEpaxI><gaNaH:BvAxiH><level:1>
yawawA	yaw1<kqw_prawyayaH:Sawrq><XAwuH:yawIz><gaNaH:BvAxiH><kqw_pratipadika:yawan><vargaH:nA><lifgam:puM><viBakwiH:3><vacanam:eka><level:1>
yawawAm	<kqw_XAwu:yaw1><kqw_prawyayaH:Sawq_lat><XAwuH:yawIz><gaNaH:BvAxiH>yawaw<vargaH:nA><lifgam:puM><viBakwiH:6><vacanam:bahu><level:1>
yawawaH	yawaw<vargaH:nA><lifgam:puM><viBakwiH:2><vacanam:bahu><level:1>/yawaw<vargaH:nA><lifgam:puM><viBakwiH:5><vacanam:eka><level:1>/yawaw<vargaH:nA><lifgam:puM><viBakwiH:6><vacanam:eka><level:1>
yawawi	yaw1<prayogaH:karwari><lakAraH:lat><puruRaH:pra><vacanam:eka><paxI:parasmEpaxI><gaNaH:BvAxiH><level:1>
yogeSvara	yogeSvara<vargaH:nA><lifgam:puM><viBakwiH:8><vacanam:eka><level:1>
yowsyamAnAn	yowsyamAna<vargaH:nA><lifgam:puM><viBakwiH:2><vacanam:bahu><level:1>
yuXya	yuX1<upasarga:Af><prayogaH:karwari><lakAraH:lot><puruRaH:ma><vacanam:eka><paxI:parasmEpaxI><XAwuH:yuXaz><gaNaH:xivAxiH><level:1>
zsanwuRtaH	wuR1<upasarga:sam><kqw_prawyayaH:kwa><XAwuH:wuRaz><gaNaH:xivAxiH>sanwuRta<vargaH:nA><lifgam:puM><viBakwiH:1><vacanam:eka><level:1>
